злоязычный|проклинающий	<b>злояз<u class="accent">ы</u>чный</b><br/><i class="p"><font color="green">прил.</font></i><p style="padding-left:1em;margin:0">maledictory</p>
злые чары	<p style="padding-left:1em;margin:0">evil spell <i class="p"><font color="green">ед.</font></i>, devilment <i class="p"><font color="green">ед.</font></i></p>
злые языки	<p style="padding-left:1em;margin:0">evil tongues, malicious gossips</p>
злюка	<b>зл<u class="accent">ю</u>ка</b><br/><object type="audio/x-wav" data="05112.wav" width="40" height="40"><param name="autoplay" value="false" /></object><br/><i class="p"><font color="green">м.р.</font></i><font color="green">;</font> <i class="p"><font color="green">ж.р.</font></i><font color="green">;</font> <i class="p"><font color="green">разг.</font></i><p style="padding-left:1em;margin:0">malicious / ill-tempered person, grouch</p>
злючка	<b>зл<u class="accent">ю</u>чка</b><br/><i class="p"><font color="green">ж.р.</font></i><font color="green">;</font> <i class="p"><font color="green">разг.</font></i><p style="padding-left:1em;margin:0">spitfire, scratch-cat</p>
злющий	<b>зл<u class="accent">ю</u>щий</b><br/><i class="p"><font color="green">прил.</font></i><font color="green">;</font> <i class="p"><font color="green">разг.</font></i><p style="padding-left:1em;margin:0">furious, very angry, enraged</p>
змеевидный	<b>змеев<u class="accent">и</u>дный</b><br/><i class="p"><font color="green">прил.</font></i><p style="padding-left:1em;margin:0">serpentine; sinuous, writhing</p>
змеевик	<b>змеев<u class="accent">и</u>к</b><br/><i class="p"><font color="green">м.р.</font></i><p style="padding-left:1em;margin:0"><font color="brown">1)</font> <i class="p"><font color="green">тех.</font></i><br/> coil (pipe)</p><p style="padding-left:1em;margin:0"><font color="brown">2)</font> <i class="p"><font color="green">минер.</font></i><br/> serpentine, ophite</p>
змееныш	<font color="green">(змеёныш)</font> <i class="p"><font color="green">м.р.</font></i><p style="padding-left:1em;margin:0">young snake; viper, treacherous / wicked creature <i class="p"><font color="green">перен.</font></i></p>
змееподобный	<b>змеепод<u class="accent">о</u>бный</b><br/><i class="p"><font color="green">прил.</font></i><p style="padding-left:1em;margin:0">ophidian</p>
змеепоклонство	<b>змеепокл<u class="accent">о</u>нство</b><br/><i class="p"><font color="green">c.р.</font></i><p style="padding-left:1em;margin:0">ophiolatry</p>
змеешейка	<b>змееш<u class="accent">е</u>йка</b><br/><i class="p"><font color="green">ж.р.</font></i><font color="green">;</font> <i class="p"><font color="green">зоол.</font></i><p style="padding-left:1em;margin:0">darter</p>
змеиный	<object type="audio/x-wav" data="05113.wav" width="40" height="40"><param name="autoplay" value="false" /></object><br/><i class="p"><font color="green">прил.</font></i> <i class="p"><font color="green">от</font></i> <a href="bword://змея">змея</a>
змеиться	<b>зме<u class="accent">и</u>ться</b><br/><i class="p"><font color="green">несовер.</font></i><p style="padding-left:1em;margin:0">meander, wind, snake, coil <i>(извиваться)</i>; glide by <i>(скользить)</i></p>
змей	<object type="audio/x-wav" data="05114.wav" width="40" height="40"><param name="autoplay" value="false" /></object><br/><i class="p"><font color="green">м.р.</font></i><p style="padding-left:1em;margin:0"><font color="brown">1)</font> dragon, serpent</p><p style="padding-left:1em;margin:0"><font color="brown">2)</font> kite</p><p style="padding-left:1em;margin:0"><span class="sec">•</span></p><p style="padding-left:1em;margin:0"><span class="sec">- <a href="bword://запускать змея">запускать змея</a></span></p><p style="padding-left:1em;margin:0"><span class="sec">- <a href="bword://воздушный змей">воздушный змей</a></span></p><p style="padding-left:1em;margin:0"><span class="sec">- <a href="bword://заклинатель змей">заклинатель змей</a></span></p>
змейка	<i class="p"><font color="green">уменьш.</font></i> <i class="p"><font color="green">от</font></i> <a href="bword://змея">змея</a>
змея	<b>зме<u class="accent">я</u></b><br/><object type="audio/x-wav" data="05115.wav" width="40" height="40"><param name="autoplay" value="false" /></object><br/><i class="p"><font color="green">ж.р.</font></i><p style="padding-left:1em;margin:0">snake, serpent</p><p style="padding-left:2em;margin:0"><span class="sec"><span class="ex"><font color="steelblue">гремучая змея — rattlesnake</font></span></span></p><p style="padding-left:2em;margin:0"><span class="sec"><span class="ex"><font color="steelblue">жало змеи — forked tongue of a snake</font></span></span></p><p style="padding-left:2em;margin:0"><span class="sec"><span class="ex"><font color="steelblue">змея подколодная — snake in the grass</font></span></span></p><p style="padding-left:2em;margin:0"><span class="sec"><span class="ex"><font color="steelblue">укротитель змей — snake-charmer</font></span></span></p><p style="padding-left:2em;margin:0"><span class="sec"><span class="ex"><font color="steelblue">ядовитая змея — venomous / poisonous snake</font></span></span></p><p style="padding-left:2em;margin:0"><span class="sec">- <a href="bword://морская змея">морская змея</a></span></p><p style="padding-left:2em;margin:0"><span class="sec">- <a href="bword://очковая змея">очковая змея</a></span></p><p style="padding-left:1em;margin:0"><span class="sec">•</span></p><p style="padding-left:1em;margin:0"><span class="sec"><span class="ex"><font color="steelblue">пригреть змею на груди — to keep / cherish a snake in one's bosom</font></span></span></p><p style="padding-left:1em;margin:0">- <a href="bword://змея подколодная">змея подколодная</a></p>
змея подколодная	<p style="padding-left:1em;margin:0"><i class="p"><font color="green">разг.</font></i> snake in the grass, viper</p>
змий	<b>зм<u class="accent">и</u>й</b><br/><i class="p"><font color="green">м.р.</font></i><font color="green">;</font> <i class="p"><font color="green">уст.</font></i><p style="padding-left:1em;margin:0">serpent</p>
знавать	<b>знав<u class="accent">а</u>ть</b><br/><font color="green">(кого-л./</font><i class="p"><font color="green">что-л.</font></i><font color="green">)</font> <i class="p"><font color="green">несовер.</font></i><font color="green">;</font> <i class="p"><font color="green">разг.</font></i><p style="padding-left:1em;margin:0"><i>(употребляется только в прошедшем времени <i class="p"><font color="green">||</font></i> used only in the past tense)</i> have known</p><p style="padding-left:2em;margin:0"><span class="sec"><span class="ex"><font color="steelblue">он знавал лучшие времена — he has known better times</font></span></span></p>
знак	<object type="audio/x-wav" data="05116.wav" width="40" height="40"><param name="autoplay" value="false" /></object><br/><i class="p"><font color="green">м.р.</font></i><p style="padding-left:1em;margin:0"><font color="brown">1)</font> sign, mark; token, symbol, badge <i>(символ)</i></p><p style="padding-left:2em;margin:0"><span class="sec"><span class="ex"><font color="steelblue">расстановка знаков препинания — punctuation</font></span></span></p><p style="padding-left:2em;margin:0"><span class="sec"><span class="ex"><font color="steelblue">дорожный знак "переход" — beacon <i>(в Великобритании)</font></span></i></span></p><p style="padding-left:2em;margin:0"><span class="sec">- <a href="bword://знак победы">знак победы</a></span></p><p style="padding-left:2em;margin:0"><span class="sec">- <a href="bword://знак поворота">знак поворота</a></span></p><p style="padding-left:2em;margin:0"><span class="sec">- <a href="bword://знак параграфа">знак параграфа</a></span></p><p style="padding-left:2em;margin:0"><span class="sec">- <a href="bword://знак повторения">знак повторения</a></span></p><p style="padding-left:2em;margin:0"><span class="sec">- <a href="bword://знак сноски">знак сноски</a></span></p><p style="padding-left:2em;margin:0"><span class="sec">- <a href="bword://знак плюс">знак плюс</a></span></p><p style="padding-left:2em;margin:0"><span class="sec">- <a href="bword://знак обелиск">знак обелиск</a></span></p><p style="padding-left:2em;margin:0"><span class="sec">- <a href="bword://знак минуса">знак минуса</a></span></p><p style="padding-left:2em;margin:0"><span class="sec">- <a href="bword://математический знак">математический знак</a></span></p><p style="padding-left:2em;margin:0"><span class="sec">- <a href="bword://знак вставки">знак вставки</a></span></p><p style="padding-left:2em;margin:0"><span class="sec">- <a href="bword://знак придыхания">знак придыхания</a></span></p><p style="padding-left:2em;margin:0"><span class="sec">- <a href="bword://знак ударения">знак ударения</a></span></p><p style="padding-left:2em;margin:0"><span class="sec">- <a href="bword://восклицательный знак">восклицательный знак</a></span></p><p style="padding-left:2em;margin:0"><span class="sec">- <a href="bword://вопросительный знак">вопросительный знак</a></span></p><p style="padding-left:2em;margin:0"><span class="sec">- <a href="bword://знак препинания">знак препинания</a></span></p><p style="padding-left:2em;margin:0"><span class="sec">- <a href="bword://знаки препинания">знаки препинания</a></span></p><p style="padding-left:2em;margin:0"><span class="sec">- <a href="bword://водяной знак">водяной знак</a></span></p><p style="padding-left:2em;margin:0"><span class="sec">- <a href="bword://диакритический знак">диакритический знак</a></span></p><p style="padding-left:2em;margin:0"><span class="sec">- <a href="bword://дорожный знак">дорожный знак</a></span></p><p style="padding-left:2em;margin:0"><span class="sec">- <a href="bword://знак деления">знак деления</a></span></p><p style="padding-left:2em;margin:0"><span class="sec">- <a href="bword://знак переноса">знак переноса</a></span></p><p style="padding-left:2em;margin:0"><span class="sec">- <a href="bword://знак равенства">знак равенства</a></span></p><p style="padding-left:2em;margin:0"><span class="sec">- <a href="bword://ключевой знак">ключевой знак</a></span></p><p style="padding-left:2em;margin:0"><span class="sec">- <a href="bword://корректурные знаки">корректурные знаки</a></span></p><p style="padding-left:2em;margin:0"><span class="sec">- <a href="bword://нагрудный знак">нагрудный знак</a></span></p><p style="padding-left:2em;margin:0"><span class="sec">- <a href="bword://надстрочные знаки">надстрочные знаки</a></span></p><p style="padding-left:2em;margin:0"><span class="sec">- <a href="bword://твердый знак">твердый знак</a></span></p><p style="padding-left:2em;margin:0"><span class="sec">- <a href="bword://товарный знак">товарный знак</a></span></p><p style="padding-left:2em;margin:0"><span class="sec">- <a href="bword://условный знак">условный знак</a></span></p><p style="padding-left:2em;margin:0"><span class="sec">- <a href="bword://фирменный знак">фирменный знак</a></span></p><p style="padding-left:2em;margin:0"><span class="sec">- <a href="bword://книжный знак">книжный знак</a></span></p><p style="padding-left:2em;margin:0"><span class="sec">- <a href="bword://двоичный знак">двоичный знак</a></span></p><p style="padding-left:1em;margin:0"><font color="brown">2)</font> <i>(предзнаменование)</i><br/> omen</p><p style="padding-left:1em;margin:0"><font color="brown">3)</font> <i>(сигнал)</i><br/> signal</p><p style="padding-left:2em;margin:0"><span class="sec"><span class="ex"><font color="steelblue">делать знаки рукой — to beck</font></span></span></p><p style="padding-left:2em;margin:0"><span class="sec">- <a href="bword://подавать знак">подавать знак</a></span></p><p style="padding-left:1em;margin:0"><span class="sec">•</span></p><p style="padding-left:1em;margin:0">- <a href="bword://денежный знак">денежный знак</a></p><p style="padding-left:1em;margin:0">- <a href="bword://фабричный знак">фабричный знак</a></p><p style="padding-left:1em;margin:0">- <a href="bword://дорожные знаки">дорожные знаки</a></p><p style="padding-left:1em;margin:0">- <a href="bword://знаки отличия">знаки отличия</a></p><p style="padding-left:1em;margin:0">- <a href="bword://знаки различия">знаки различия</a></p><p style="padding-left:1em;margin:0">- <a href="bword://под знаком">под знаком</a></p><p style="padding-left:1em;margin:0">- <a href="bword://в знак">в знак</a></p>
знак вставки	<i class="p"><font color="green">%%</font></i> <font color="green">;</font> <i class="p"><font color="green">полигр.</font></i><p style="padding-left:1em;margin:0"><i>(буквы или слова)</i> caret</p>
знак деления	<i class="p"><font color="green">%%</font></i> <font color="green">;</font> <i class="p"><font color="green">мат.</font></i><p style="padding-left:1em;margin:0">division sign</p>
знак корня	<p style="padding-left:1em;margin:0">radical sign</p>
знак минуса	<p style="padding-left:1em;margin:0">minus</p>
знак обелиск	<i class="p"><font color="green">%%</font></i> <font color="green">;</font> <i class="p"><font color="green">полигр.</font></i><p style="padding-left:1em;margin:0">obelus</p>
знак отличия	<p style="padding-left:1em;margin:0">decoration, order <i class="p"><font color="green">воен.</font></i>; insignia <i class="p"><font color="green">мн.</font></i></p>
знак параграфа	<p style="padding-left:1em;margin:0">section-mark</p>
знак переноса	<p style="padding-left:1em;margin:0">hyphen</p>
знак плюс	<p style="padding-left:1em;margin:0">plus</p>
знак победы	<p style="padding-left:1em;margin:0">V-sign</p>
знак поворота	<p style="padding-left:1em;margin:0">turn signal</p>
знак повторения	<p style="padding-left:1em;margin:0">repeat</p>
знак препинания	<i class="p"><font color="green">%%</font></i> <font color="green">;</font> <i class="p"><font color="green">грам.</font></i><p style="padding-left:1em;margin:0">punctuation mark</p>
знак придыхания	<i class="p"><font color="green">%%</font></i> <font color="green">;</font> <i class="p"><font color="green">фон.</font></i><p style="padding-left:1em;margin:0">aspirate</p>
знак равенства	<p style="padding-left:1em;margin:0"><i class="p"><font color="green">мат.</font></i> sign of equality, equals sign</p><p style="padding-left:2em;margin:0"><span class="sec"><span class="ex"><font color="steelblue">ставить знак равенства — to equate smth. with smth.</font></span></span></p>
знак сноски	<i class="p"><font color="green">%%</font></i> <font color="green">;</font> <i class="p"><font color="green">полигр.</font></i><p style="padding-left:1em;margin:0">reference mark</p>
знак ударения	<p style="padding-left:1em;margin:0">stress mark, accent (mark)</p>
знаки зодиака	<p style="padding-left:1em;margin:0">signs of the zodiac</p>
знаки отличия	<p style="padding-left:1em;margin:0">decoration, medal <i class="p"><font color="green">ед.</font></i></p><p style="padding-left:2em;margin:0"><span class="sec"><span class="ex"><font color="steelblue">военные знаки отличия — military insignia</font></span></span></p>
знаки препинания	<p style="padding-left:1em;margin:0"><i class="p"><font color="green">грам.</font></i> stops, punctuation marks</p>
знаки различия	<p style="padding-left:1em;margin:0">badge of rank</p>
знаковый	<b>зн<u class="accent">а</u>ковый</b><br/><p style="padding-left:1em;margin:0"><i class="p"><font color="green">прил.</font></i></p><p style="padding-left:2em;margin:0"><span class="sec"><b>See:</b></span></p><p style="padding-left:2em;margin:0"><span class="sec"><a href="bword://знак">знак</a></span></p><br/> (<i>примечательный, показательный, символичный</i>) emblematic, symbolic, indicative
знакомая	<b>знак<u class="accent">о</u>мая</b><br/><i class="p"><font color="green">ж.р.</font></i><p style="padding-left:1em;margin:0">acquaintance</p>
знакомец	<b>знак<u class="accent">о</u>мец</b><br/><p style="padding-left:1em;margin:0"><i class="p"><font color="green">м.р.</font></i><font color="green">;</font> <i class="p"><font color="green">уст.</font></i><font color="green">;</font> <i class="p"><font color="green">разг.</font></i></p><p style="padding-left:1em;margin:0">(<i>знакомый человек</i>) pal</p>
знакомить	<b>знак<u class="accent">о</u>мить</b><br/><object type="audio/x-wav" data="05117.wav" width="40" height="40"><param name="autoplay" value="false" /></object><br/><i class="p"><font color="green">несовер.</font></i> <font color="green">– знакомить;</font> <i class="p"><font color="green">совер.</font></i> <font color="green">– познакомить (кого-л. с кем-л./чем-л.)</font><p style="padding-left:1em;margin:0">introduce (to) <i>(представлять)</i>; acquaint (with)</p>
знакомиться	<b>знак<u class="accent">о</u>миться</b><br/><object type="audio/x-wav" data="05118.wav" width="40" height="40"><param name="autoplay" value="false" /></object><br/><i class="p"><font color="green">несовер.</font></i> <font color="green">– знакомиться;</font> <i class="p"><font color="green">совер.</font></i> <font color="green">– познакомиться (с кем-л./чем-л.)</font><p style="padding-left:1em;margin:0"><font color="brown">1)</font> <i class="p"><font color="green">взаим.-возвр.</font></i> meet; make the acquaintance (of), make smb.'s acquaintance, become acquainted (with)</p><p style="padding-left:1em;margin:0"><font color="brown">2)</font> <i>(ознакомиться)</i> familiarize oneself (with), go (into); <i>(осматривать, посещать)</i> visit; see</p>
знакомство	<b>знак<u class="accent">о</u>мство</b><br/><object type="audio/x-wav" data="05119.wav" width="40" height="40"><param name="autoplay" value="false" /></object><br/><i class="p"><font color="green">c.р.</font></i><p style="padding-left:1em;margin:0"><font color="brown">1)</font> acquaintance; circle of friends; <i class="p"><font color="green">мн.</font></i> connexion, contact</p><p style="padding-left:1em;margin:0"><font color="brown">2)</font> <i>(с кем-л. / чем-л.)</i> familiarity (with)</p><p style="padding-left:2em;margin:0"><span class="sec"><span class="ex"><font color="steelblue">водить знакомство <i>(с кем-л.)</i> — to keep up an acquaintance (with)</font></span></span></p><p style="padding-left:2em;margin:0"><span class="sec">- <a href="bword://прекращать знакомство">прекращать знакомство</a></span></p><p style="padding-left:2em;margin:0"><span class="sec">- <a href="bword://шапочное знакомство">шапочное знакомство</a></span></p><p style="padding-left:2em;margin:0"><span class="sec">- <a href="bword://заводить знакомство">заводить знакомство</a></span></p><p style="padding-left:2em;margin:0"><span class="sec">- <a href="bword://поддерживать знакомство">поддерживать знакомство</a></span></p><p style="padding-left:2em;margin:0"><span class="sec">- <a href="bword://по знакомству">по знакомству</a></span></p><p style="padding-left:2em;margin:0"><span class="sec">- <a href="bword://короткое знакомство">короткое знакомство</a></span></p><p style="padding-left:2em;margin:0"><span class="sec">- <a href="bword://завязывать знакомство">завязывать знакомство</a></span></p>
знакомый	<b>знак<u class="accent">о</u>мый</b><br/><p style="padding-left:1em;margin:0"><b>1.</b> <object type="audio/x-wav" data="05120.wav" width="40" height="40"><param name="autoplay" value="false" /></object><br/><i class="p"><font color="green">прил.</font></i></p><p style="padding-left:1em;margin:0"><font color="brown">1)</font> known</p><p style="padding-left:2em;margin:0"><span class="sec"><span class="ex"><font color="steelblue">хорошо знакомый — well-known, old-hat; familiar; conversant</font></span></span></p><p style="padding-left:1em;margin:0"><font color="brown">2)</font> <i>(с кем-л. / чем-л.)</i> familiar, acquainted (with)</p><p style="padding-left:1em;margin:0"><b>2.</b> <i class="p"><font color="green">м.р.</font></i><font color="green">;</font> <i class="p"><font color="green">скл. как прил.</font></i></p><p style="padding-left:1em;margin:0">acquaintance; friend</p><p style="padding-left:2em;margin:0"><span class="sec">- <a href="bword://добрый знакомый">добрый знакомый</a></span></p><p style="padding-left:2em;margin:0"><span class="sec">- <a href="bword://шапочный знакомый">шапочный знакомый</a></span></p>
знаменатель	<b>знамен<u class="accent">а</u>тель</b><br/><object type="audio/x-wav" data="05121.wav" width="40" height="40"><param name="autoplay" value="false" /></object><br/><i class="p"><font color="green">м.р.</font></i><font color="green">;</font> <i class="p"><font color="green">мат.</font></i><p style="padding-left:1em;margin:0">denominator</p><p style="padding-left:2em;margin:0"><span class="sec"><span class="ex"><font color="steelblue">привести к общему знаменателю — to reduce to a common denominator</font></span></span></p><p style="padding-left:2em;margin:0"><span class="sec">- <a href="bword://общий знаменатель">общий знаменатель</a></span></p>
знаменательная дата	<p style="padding-left:1em;margin:0">historical date</p>
знаменательный	<b>знамен<u class="accent">а</u>тельный</b><br/><object type="audio/x-wav" data="05122.wav" width="40" height="40"><param name="autoplay" value="false" /></object><br/><i class="p"><font color="green">прил.</font></i><p style="padding-left:1em;margin:0"><font color="brown">1)</font> memorable, momentous, remarkable; significant, suggestive</p><p style="padding-left:2em;margin:0"><span class="sec">- <a href="bword://знаменательная дата">знаменательная дата</a></span></p><p style="padding-left:1em;margin:0"><font color="brown">2)</font> <i class="p"><font color="green">лингв.</font></i><br/> notional, categorematic, of full meaning</p>
знамение	<b>зн<u class="accent">а</u>мение</b><br/><i class="p"><font color="green">c.р.</font></i><font color="green">;</font> <i class="p"><font color="green">уст.</font></i><p style="padding-left:1em;margin:0">sign</p><p style="padding-left:2em;margin:0"><span class="sec">- <a href="bword://осенять крестным знамением">осенять крестным знамением</a></span></p><p style="padding-left:2em;margin:0"><span class="sec">- <a href="bword://крестное знамение">крестное знамение</a></span></p>
знаменитость	<b>знамен<u class="accent">и</u>тость</b><br/><object type="audio/x-wav" data="05123.wav" width="40" height="40"><param name="autoplay" value="false" /></object><br/><i class="p"><font color="green">ж.р.</font></i><p style="padding-left:1em;margin:0">fame, renown, eminence, celebrity; celebrity <i>(о человеке <i class="p"><font color="green">||</font></i> a person)</i></p>
знаменитый	<b>знамен<u class="accent">и</u>тый</b><br/><object type="audio/x-wav" data="05124.wav" width="40" height="40"><param name="autoplay" value="false" /></object><br/><i class="p"><font color="green">прил.</font></i><p style="padding-left:1em;margin:0">famous, renowned, celebrated, illustrious</p>
знаменитый человек	<p style="padding-left:1em;margin:0">celebrity, famous person</p>
знаменовать	<b>знаменов<u class="accent">а</u>ть</b><br/><font color="green">(</font><i class="p"><font color="green">что-л.</font></i><font color="green">)</font> <i class="p"><font color="green">несовер.</font></i><p style="padding-left:1em;margin:0">express, signify, mark, represent</p>
знаменосец	<b>знамен<u class="accent">о</u>сец</b><br/><i class="p"><font color="green">м.р.</font></i><p style="padding-left:1em;margin:0">standard bearer</p>
знамя	<b>зн<u class="accent">а</u>мя</b><br/><object type="audio/x-wav" data="05125.wav" width="40" height="40"><param name="autoplay" value="false" /></object><br/><i class="p"><font color="green">c.р.</font></i><p style="padding-left:1em;margin:0">banner, flag; standard, colours <i class="p"><font color="green">воен.</font></i></p><p style="padding-left:2em;margin:0"><span class="sec">- <a href="bword://поднимать знамя">поднимать знамя</a></span></p><p style="padding-left:2em;margin:0"><span class="sec">- <a href="bword://под знаменем">под знаменем</a></span></p><p style="padding-left:2em;margin:0"><span class="sec">- <a href="bword://высоко держать знамя">высоко держать знамя</a></span></p><p style="padding-left:2em;margin:0"><span class="sec">- <a href="bword://стать под знамя">стать под знамя</a></span></p>
знание	<b>зн<u class="accent">а</u>ние</b><br/><object type="audio/x-wav" data="05126.wav" width="40" height="40"><param name="autoplay" value="false" /></object><br/><i class="p"><font color="green">c.р.</font></i><p style="padding-left:1em;margin:0">knowledge; erudition; <i class="p"><font color="green">мн.</font></i> attainments, information; reading <i>(начитанность)</i></p><p style="padding-left:2em;margin:0"><span class="sec"><span class="ex"><font color="steelblue">углублять свои знания — to extend one's knowledge</font></span></span></p><p style="padding-left:2em;margin:0"><span class="sec"><span class="ex"><font color="steelblue">высокий уровень знаний — high standard of knowledge</font></span></span></p><p style="padding-left:2em;margin:0"><span class="sec"><span class="ex"><font color="steelblue">хорошее знание — <i>(чего-л.)</i> intimate knowledge of</font></span></span></p><p style="padding-left:2em;margin:0"><span class="sec">- <a href="bword://со знанием дела">со знанием дела</a></span></p><p style="padding-left:2em;margin:0"><span class="sec">- <a href="bword://энциклопедические знания">энциклопедические знания</a></span></p><p style="padding-left:2em;margin:0"><span class="sec">- <a href="bword://элементарные знания">элементарные знания</a></span></p><p style="padding-left:2em;margin:0"><span class="sec">- <a href="bword://черпать знания">черпать знания</a></span></p><p style="padding-left:2em;margin:0"><span class="sec">- <a href="bword://фундаментальные знания">фундаментальные знания</a></span></p><p style="padding-left:2em;margin:0"><span class="sec">- <a href="bword://умножать знания">умножать знания</a></span></p><p style="padding-left:2em;margin:0"><span class="sec">- <a href="bword://тяга к знаниям">тяга к знаниям</a></span></p><p style="padding-left:2em;margin:0"><span class="sec">- <a href="bword://твердые знания">твердые знания</a></span></p><p style="padding-left:2em;margin:0"><span class="sec">- <a href="bword://пробелы в знаниях">пробелы в знаниях</a></span></p><p style="padding-left:2em;margin:0"><span class="sec">- <a href="bword://поверхностное знание">поверхностное знание</a></span></p><p style="padding-left:2em;margin:0"><span class="sec">- <a href="bword://запас знаний">запас знаний</a></span></p><p style="padding-left:2em;margin:0"><span class="sec">- <a href="bword://жажда знаний">жажда знаний</a></span></p><p style="padding-left:2em;margin:0"><span class="sec">- <a href="bword://глубокое знание">глубокое знание</a></span></p><p style="padding-left:2em;margin:0"><span class="sec">- <a href="bword://проверка знаний">проверка знаний</a></span></p>
знатность	<b>зн<u class="accent">а</u>тность</b><br/><i class="p"><font color="green">ж.р.</font></i><p style="padding-left:1em;margin:0">gentility, gentlehood, grandeur</p>
знатный	<b>зн<u class="accent">а</u>тный</b><br/><object type="audio/x-wav" data="05127.wav" width="40" height="40"><param name="autoplay" value="false" /></object><br/><i class="p"><font color="green">прил.</font></i><p style="padding-left:1em;margin:0"><font color="brown">1)</font> noble</p><p style="padding-left:1em;margin:0"><font color="brown">2)</font> <i class="p"><font color="green">разг.</font></i> <i>(отличный)</i><br/> whacking, splendid</p>
знаток	<b>знат<u class="accent">о</u>к</b><br/><object type="audio/x-wav" data="05128.wav" width="40" height="40"><param name="autoplay" value="false" /></object><br/><i class="p"><font color="green">м.р.</font></i><font color="green">; (чего-л.)</font><p style="padding-left:1em;margin:0">expert (on); connoisseur (of)</p><p style="padding-left:2em;margin:0"><span class="sec"><span class="ex"><font color="steelblue">быть знатоком своего дела — to know one's trade / business</font></span></span></p><p style="padding-left:2em;margin:0"><span class="sec">- <a href="bword://тонкий знаток">тонкий знаток</a></span></p>
знаток в кавычках	<p style="padding-left:1em;margin:0">would-be expert</p>
знать	<b>I</b> <object type="audio/x-wav" data="05129.wav" width="40" height="40"><param name="autoplay" value="false" /></object><br/><font color="green">(кого-л./</font><i class="p"><font color="green">что-л.</font></i> <font color="green">о ком-л./чем-л.)</font> <i class="p"><font color="green">несовер.</font></i><p style="padding-left:1em;margin:0">know; be aware (of), be acquainted (with), be up to <i>(о чем-л. секретном)</i></p><p style="padding-left:2em;margin:0"><span class="sec"><span class="ex"><font color="steelblue">знать совершенно точно — to know beyond doubt</font></span></span></p><p style="padding-left:2em;margin:0"><span class="sec"><span class="ex"><font color="steelblue">знать кого-н. в лицо — to know someone by sight</font></span></span></p><p style="padding-left:2em;margin:0"><span class="sec"><span class="ex"><font color="steelblue">знать всю подоплеку <i>(чего-л.)</i> — to know all (about), to know the real state (of); to have inside information (on)</font></span></span></p><p style="padding-left:2em;margin:0"><span class="sec"><span class="ex"><font color="steelblue">знать все ходы и выходы — to know all the ins and outs, to be perfectly at home <i class="p"><font color="green">разг.</font></i></font></span></span></p><p style="padding-left:2em;margin:0"><span class="sec">- <a href="bword://не знать устали">не знать устали</a></span></p><p style="padding-left:2em;margin:0"><span class="sec">- <a href="bword://не знать">не знать</a></span></p><p style="padding-left:2em;margin:0"><span class="sec">- <a href="bword://знать понаслышке">знать понаслышке</a></span></p><p style="padding-left:2em;margin:0"><span class="sec">- <a href="bword://не знать покоя">не знать покоя</a></span></p><p style="padding-left:2em;margin:0"><span class="sec">- <a href="bword://знать свет">знать свет</a></span></p><p style="padding-left:1em;margin:0"><span class="sec">•</span></p><p style="padding-left:1em;margin:0"><span class="sec"><span class="ex"><font color="steelblue">кто его знает — goodness knows</font></span></span></p><p style="padding-left:1em;margin:0"><span class="sec"><span class="ex"><font color="steelblue">знать меру — to know when to stop</font></span></span></p><p style="padding-left:1em;margin:0"><span class="sec"><span class="ex"><font color="steelblue">знать, что к чему — to know the how and why of things</font></span></span></p><p style="padding-left:1em;margin:0"><span class="sec"><span class="ex"><font color="steelblue">то и знай — continually</font></span></span></p><p style="padding-left:1em;margin:0"><span class="sec"><span class="ex"><font color="steelblue">как знаешь — as you wish</font></span></span></p><p style="padding-left:1em;margin:0"><span class="sec"><span class="ex"><font color="steelblue">знать что-л. как свои пять пальцев <i class="p"><font color="green">разг.</font></i> — to have smth. at one's finger-tips; to know smth. backwards, to know smth. like the back of one's hand</font></span></span></p><p style="padding-left:1em;margin:0"><span class="sec"><span class="ex"><font color="steelblue">шут его знает! <i class="p"><font color="green">разг.</font></i> — deuce knows!</font></span></span></p><p style="padding-left:1em;margin:0"><span class="sec"><span class="ex"><font color="steelblue">почем знать? — who knows?</font></span></span></p><p style="padding-left:1em;margin:0"><span class="sec"><span class="ex"><font color="steelblue">так и знай(те) — that's for sure</font></span></span></p><p style="padding-left:1em;margin:0">- <a href="bword://давать знать">давать знать</a></p><p style="padding-left:1em;margin:0">- <a href="bword://дать себя знать">дать себя знать</a></p><p style="padding-left:1em;margin:0">- <a href="bword://давать о себе знать">давать о себе знать</a></p><br/><b>II</b> <i class="p"><font color="green">вводн.</font></i><p style="padding-left:1em;margin:0">apparently, probably</p><br/><b>III</b> <i class="p"><font color="green">ж.р.</font></i><font color="green">;</font> <i class="p"><font color="green">только</font></i> <i class="p"><font color="green">ед.</font></i><font color="green">;</font> <i class="p"><font color="green">собир.</font></i><p style="padding-left:1em;margin:0">aristocracy, nobility; the elite</p>
знать меру	<p style="padding-left:1em;margin:0">to know when to stop</p>
знать по опыту	<p style="padding-left:1em;margin:0">to know from (one's) experience (that)</p>
знать понаслышке	<p style="padding-left:1em;margin:0">to know by hearsay</p>
знать свет	<p style="padding-left:1em;margin:0">to know the world</p>
знать явку	<p style="padding-left:1em;margin:0">to know the secret address</p>
знаться	<b>зн<u class="accent">а</u>ться</b><br/><i class="p"><font color="green">несовер.</font></i><font color="green">;</font> <i class="p"><font color="green">взаим.-возвр.</font></i><font color="green">; (с кем-л.);</font> <i class="p"><font color="green">разг.</font></i><p style="padding-left:1em;margin:0">associate (with)</p><p style="padding-left:2em;margin:0"><span class="sec"><span class="ex"><font color="steelblue">он с тобой и знаться не хочет — he will have nothing to do with you</font></span></span></p>
знахарка	<i class="p"><font color="green">ж.р.</font></i><p style="padding-left:1em;margin:0">sorceress, wise woman; quack</p>
знахарский	<b>зн<u class="accent">а</u>харский</b><br/><i class="p"><font color="green">прил.</font></i><p style="padding-left:1em;margin:0">voodoo</p>
знахарство	<b>зн<u class="accent">а</u>харство</b><br/><i class="p"><font color="green">c.р.</font></i><p style="padding-left:1em;margin:0">sorcery, quackery</p>
знахарь	<b>зн<u class="accent">а</u>харь</b><br/><object type="audio/x-wav" data="05130.wav" width="40" height="40"><param name="autoplay" value="false" /></object><br/><i class="p"><font color="green">м.р.</font></i><p style="padding-left:1em;margin:0">sorcerer, wise man; witch-doctor, quack doctor</p>
значащий	<b>зн<u class="accent">а</u>чащий</b><br/><i class="p"><font color="green">прил.</font></i><font color="green">;</font> <i class="p"><font color="green">прич.</font></i> <i class="p"><font color="green">от</font></i> <a href="bword://значить">значить</a><p style="padding-left:1em;margin:0">significant, meaningful</p><p style="padding-left:2em;margin:0"><span class="sec">- <a href="bword://ничего не значащий">ничего не значащий</a></span></p>
значение	<b>знач<u class="accent">е</u>ние</b><br/><object type="audio/x-wav" data="05131.wav" width="40" height="40"><param name="autoplay" value="false" /></object><br/><i class="p"><font color="green">c.р.</font></i><p style="padding-left:1em;margin:0"><font color="brown">1)</font> significance, meaning, sense</p><p style="padding-left:2em;margin:0"><span class="sec">- <a href="bword://лексическое значение">лексическое значение</a></span></p><p style="padding-left:2em;margin:0"><span class="sec">- <a href="bword://буквальное значение">буквальное значение</a></span></p><p style="padding-left:2em;margin:0"><span class="sec">- <a href="bword://прямое значение">прямое значение</a></span></p><p style="padding-left:2em;margin:0"><span class="sec">- <a href="bword://переносное значение">переносное значение</a></span></p><p style="padding-left:2em;margin:0"><span class="sec">- <a href="bword://принятое значение слова">принятое значение слова</a></span></p><p style="padding-left:1em;margin:0"><font color="brown">2)</font> <i>(важность)</i> significance, importance</p><p style="padding-left:2em;margin:0"><span class="sec"><span class="ex"><font color="steelblue">иметь большое значение — to be of great importance</font></span></span></p><p style="padding-left:2em;margin:0"><span class="sec"><span class="ex"><font color="steelblue">иметь принципиальное значение — to be of fundamental importance</font></span></span></p><p style="padding-left:2em;margin:0"><span class="sec"><span class="ex"><font color="steelblue">иметь первостепенное значение — to be of paramount / vital / cardinal / fundamental importance, to be a prime consideration</font></span></span></p><p style="padding-left:2em;margin:0"><span class="sec"><span class="ex"><font color="steelblue">не иметь практического значения — to be of no practical importance</font></span></span></p><p style="padding-left:2em;margin:0"><span class="sec"><span class="ex"><font color="steelblue">второй по значению вопрос — the second most important question</font></span></span></p><p style="padding-left:2em;margin:0"><span class="sec"><span class="ex"><font color="steelblue">иметь всемирное значение — to be of world-wide importance</font></span></span></p><p style="padding-left:2em;margin:0"><span class="sec"><span class="ex"><font color="steelblue">возрастает значение <i>(чего-л.)</i> — (smth.) is growing in importance</font></span></span></p><p style="padding-left:2em;margin:0"><span class="sec">- <a href="bword://существенное значение">существенное значение</a></span></p><p style="padding-left:2em;margin:0"><span class="sec">- <a href="bword://большое значение">большое значение</a></span></p><p style="padding-left:2em;margin:0"><span class="sec">- <a href="bword://приобретать значение">приобретать значение</a></span></p><p style="padding-left:2em;margin:0"><span class="sec">- <a href="bword://придавать значение">придавать значение</a></span></p><p style="padding-left:1em;margin:0"><font color="brown">3)</font> <i class="p"><font color="green">мат.</font></i> value</p><p style="padding-left:2em;margin:0"><span class="sec">- <a href="bword://задавать значение">задавать значение</a></span></p><p style="padding-left:2em;margin:0"><span class="sec">- <a href="bword://абсолютное значение">абсолютное значение</a></span></p><p style="padding-left:1em;margin:0"><span class="sec">•</span></p><p style="padding-left:1em;margin:0"><span class="sec"><span class="ex"><font color="steelblue">огромное значение — paramount / prime / cardinal / great / tremendous importance</font></span></span></p><p style="padding-left:1em;margin:0"><span class="sec"><span class="ex"><font color="steelblue">не иметь большого значения — to be of little consequence / importance / significance</font></span></span></p><p style="padding-left:1em;margin:0"><span class="sec"><span class="ex"><font color="steelblue">не иметь значения — to be of no concern / significance / importance, to make no difference, to be immaterial</font></span></span></p><p style="padding-left:1em;margin:0"><span class="sec">- <a href="bword://решающее значение">решающее значение</a></span></p><p style="padding-left:1em;margin:0"><span class="sec">- <a href="bword://практическое значение">практическое значение</a></span></p>
значимость	<b>зн<u class="accent">а</u>чимость</b><br/><object type="audio/x-wav" data="05132.wav" width="40" height="40"><param name="autoplay" value="false" /></object><br/><i class="p"><font color="green">ж.р.</font></i><p style="padding-left:1em;margin:0">amount, concernment, consequence, magnitude, meaning, moment, solemnity</p>
значимый	<b>зн<u class="accent">а</u>чимый</b><br/><object type="audio/x-wav" data="05133.wav" width="40" height="40"><param name="autoplay" value="false" /></object><br/><i class="p"><font color="green">прил.</font></i><font color="green">;</font> <i class="p"><font color="green">прич.</font></i> <i class="p"><font color="green">от</font></i> <a href="bword://значить">значить</a><p style="padding-left:1em;margin:0">significant, important</p>
значит	<b>зн<u class="accent">а</u>чит</b><br/><object type="audio/x-wav" data="05134.wav" width="40" height="40"><param name="autoplay" value="false" /></object><br/><i class="p"><font color="green">частица</font></i><font color="green">;</font> <i class="p"><font color="green">разг.</font></i><p style="padding-left:1em;margin:0">so, then, well</p>
значительно	<b>знач<u class="accent">и</u>тельно</b><br/><object type="audio/x-wav" data="05135.wav" width="40" height="40"><param name="autoplay" value="false" /></object><br/><i class="p"><font color="green">нареч.</font></i><p style="padding-left:1em;margin:0">greatly, lot, noticeably, way, well, too much</p>
значительное количество	<p style="padding-left:1em;margin:0">a great deal</p>
значительность	<b>знач<u class="accent">и</u>тельность</b><br/><i class="p"><font color="green">ж.р.</font></i><p style="padding-left:1em;margin:0">amount, consequence, import, importance, magnitude, meaning, moment, notability, significance</p>
значительный	<b>знач<u class="accent">и</u>тельный</b><br/><object type="audio/x-wav" data="05136.wav" width="40" height="40"><param name="autoplay" value="false" /></object><br/><i class="p"><font color="green">прил.</font></i><p style="padding-left:1em;margin:0"><font color="brown">1)</font> considerable; sizeable; substantial</p><p style="padding-left:1em;margin:0"><font color="brown">2)</font> <i>(важный)</i><br/> important</p><p style="padding-left:1em;margin:0"><font color="brown">3)</font> <i>(выразительный)</i><br/> significant, suggestive, meaningful</p>
значить	<b>зн<u class="accent">а</u>чить</b><br/><object type="audio/x-wav" data="05137.wav" width="40" height="40"><param name="autoplay" value="false" /></object><br/><i class="p"><font color="green">несовер.</font></i><font color="green">;</font> <i class="p"><font color="green">без доп.</font></i><p style="padding-left:1em;margin:0"><font color="brown">1)</font> mean, signify; matter</p><p style="padding-left:1em;margin:0"><font color="brown">2)</font> mean, have significance, be of importance</p><p style="padding-left:1em;margin:0"><span class="sec">•</span></p><p style="padding-left:1em;margin:0"><span class="sec"><span class="ex"><font color="steelblue">Что значит молодость! — That's what comes of being young!</font></span></span></p>
значиться	<b>зн<u class="accent">а</u>читься</b><br/><object type="audio/x-wav" data="05138.wav" width="40" height="40"><param name="autoplay" value="false" /></object><br/><i class="p"><font color="green">несовер.</font></i><p style="padding-left:1em;margin:0">be registered; be, be mentioned, appear</p>
значок	<b>знач<u class="accent">о</u>к</b><br/><object type="audio/x-wav" data="05139.wav" width="40" height="40"><param name="autoplay" value="false" /></object><br/><i class="p"><font color="green">м.р.</font></i><p style="padding-left:1em;margin:0"><font color="brown">1)</font> pin; badge; <i class="p"><font color="green">мн.</font></i> insignia <i class="p"><font color="green">лат.</font></i></p><p style="padding-left:2em;margin:0"><span class="sec"><span class="ex"><font color="steelblue">предвыборный значок (<i>с портретом кандидата</i>) — badge / campaign button</font></span></span></p><p style="padding-left:1em;margin:0"><font color="brown">2)</font> sign</p>
знающий	<b>зн<u class="accent">а</u>ющий</b><br/><object type="audio/x-wav" data="05140.wav" width="40" height="40"><param name="autoplay" value="false" /></object><br/><i class="p"><font color="green">прил.</font></i><p style="padding-left:1em;margin:0">able, adept, advised, aware, competent, conversant, informed, knowing, literate, qualified, read, sciential, studied, wise</p><p style="padding-left:2em;margin:0"><span class="sec"><span class="ex"><font color="steelblue">знающий свое дело — efficient</font></span></span></p>
знобить	<b>зноб<u class="accent">и</u>ть</b><br/><i class="p"><font color="green">несовер.</font></i><font color="green">;</font> <i class="p"><font color="green">безл.</font></i><p style="padding-left:1em;margin:0"><i>употребляется только в сочетаниях</i></p><p style="padding-left:2em;margin:0"><span class="sec"><span class="ex"><font color="steelblue">меня знобит — I feel chilly</font></span></span></p>
зной	<object type="audio/x-wav" data="05141.wav" width="40" height="40"><param name="autoplay" value="false" /></object><br/><i class="p"><font color="green">м.р.</font></i><p style="padding-left:1em;margin:0">heat, sultriness</p>
знойный	<b>зн<u class="accent">о</u>йный</b><br/><object type="audio/x-wav" data="05142.wav" width="40" height="40"><param name="autoplay" value="false" /></object><br/><i class="p"><font color="green">прил.</font></i><p style="padding-left:1em;margin:0">sultry, hot, burning</p>
зоб	<object type="audio/x-wav" data="05143.wav" width="40" height="40"><param name="autoplay" value="false" /></object><br/><i class="p"><font color="green">м.р.</font></i><p style="padding-left:1em;margin:0"><font color="brown">1)</font> crop, craw</p><p style="padding-left:1em;margin:0"><font color="brown">2)</font> <i class="p"><font color="green">мед.</font></i><br/> goitre, wen</p>
зобастый	<b>зоб<u class="accent">а</u>стый</b><br/><i class="p"><font color="green">прил.</font></i><font color="green">;</font> <i class="p"><font color="green">разг.</font></i><p style="padding-left:1em;margin:0"><font color="brown">1)</font> with a large crop / craw</p><p style="padding-left:1em;margin:0"><font color="brown">2)</font> goitrous</p>
зобастый голубь	<p style="padding-left:1em;margin:0">pouter</p>
зобный	<b>з<u class="accent">о</u>бный</b><br/><i class="p"><font color="green">прил.</font></i><p style="padding-left:1em;margin:0">goitrous</p>
зов	<object type="audio/x-wav" data="05144.wav" width="40" height="40"><param name="autoplay" value="false" /></object><br/><i class="p"><font color="green">м.р.</font></i><p style="padding-left:1em;margin:0">call, summons; invitation <i class="p"><font color="green">разг.</font></i></p><p style="padding-left:2em;margin:0"><span class="sec"><span class="ex"><font color="steelblue">прийти по первому зову — to come at the first summons</font></span></span></p><p style="padding-left:2em;margin:0"><span class="sec">- <a href="bword://откликнуться на зов">откликнуться на зов</a></span></p>
зодиак	<b>зоди<u class="accent">а</u>к</b><br/><object type="audio/x-wav" data="05145.wav" width="40" height="40"><param name="autoplay" value="false" /></object><br/><i class="p"><font color="green">м.р.</font></i><font color="green">;</font> <i class="p"><font color="green">астр.</font></i><p style="padding-left:1em;margin:0">zodiac</p><p style="padding-left:2em;margin:0"><span class="sec">- <a href="bword://знаки зодиака">знаки зодиака</a></span></p>
зодиакальный	<b>зодиак<u class="accent">а</u>льный</b><br/><i class="p"><font color="green">прил.</font></i><font color="green">;</font> <i class="p"><font color="green">астр.</font></i><p style="padding-left:1em;margin:0">zodiac</p>
зодческий	<b>з<u class="accent">о</u>дческий</b><br/><i class="p"><font color="green">прил.</font></i><p style="padding-left:1em;margin:0">architectural, architectonic</p>
зодчество	<b>з<u class="accent">о</u>дчество</b><br/><object type="audio/x-wav" data="05146.wav" width="40" height="40"><param name="autoplay" value="false" /></object><br/><i class="p"><font color="green">c.р.</font></i><p style="padding-left:1em;margin:0">architecture</p>
зодчий	<b>з<u class="accent">о</u>дчий</b><br/><object type="audio/x-wav" data="05147.wav" width="40" height="40"><param name="autoplay" value="false" /></object><br/><i class="p"><font color="green">м.р.</font></i><font color="green">;</font> <i class="p"><font color="green">скл. как прил.</font></i><p style="padding-left:1em;margin:0">architect</p>
зола	<b>зол<u class="accent">а</u></b><br/><object type="audio/x-wav" data="05148.wav" width="40" height="40"><param name="autoplay" value="false" /></object><br/><i class="p"><font color="green">ж.р.</font></i><font color="green">;</font> <i class="p"><font color="green">только</font></i> <i class="p"><font color="green">ед.</font></i><p style="padding-left:1em;margin:0">ashes <i class="p"><font color="green">мн.</font></i></p>
золить	<b>зол<u class="accent">и</u>ть</b><br/><font color="green">(</font><i class="p"><font color="green">что-л.</font></i><font color="green">)</font> <i class="p"><font color="green">несовер.</font></i><p style="padding-left:1em;margin:0">lime</p>
золовка	<b>зол<u class="accent">о</u>вка</b><br/><i class="p"><font color="green">ж.р.</font></i><font color="green">;</font> <i class="p"><font color="green">мн.</font></i> <font color="green">– sisters-in-law</font><p style="padding-left:1em;margin:0">sister-in-law <i>(сестра мужа <i class="p"><font color="green">||</font></i> husband's sister)</i></p>
золотая валюта	<p style="padding-left:1em;margin:0">gold standard</p>
золотая кордоба	<i class="p"><font color="green">ж.р.</font></i><p style="padding-left:1em;margin:0"><i>(денежная единица Никрагуа)</i><br/> cordoba oro</p>
золотая лихорадка	<p style="padding-left:1em;margin:0">gold-rush</p>
золотая молодежь	<p style="padding-left:1em;margin:0">gilded youth</p>
золотая рыбка	<p style="padding-left:1em;margin:0">goldfish</p>
золотая свадьба	<p style="padding-left:1em;margin:0">golden wedding / anniversary, golden jubilee</p>
золотая середина	<p style="padding-left:1em;margin:0">the golden mean; the happy medium</p>
золотая фольга	<p style="padding-left:1em;margin:0">gold foil</p>
золотисто-каштановый	<b>золот<u class="accent">и</u>сто-каштановый</b><br/><i class="p"><font color="green">прил.</font></i><p style="padding-left:1em;margin:0"><i>(о волосах)</i> auburn, Titian</p>
золотистый	<b>золот<u class="accent">и</u>стый</b><br/><object type="audio/x-wav" data="05149.wav" width="40" height="40"><param name="autoplay" value="false" /></object><br/><i class="p"><font color="green">прил.</font></i><p style="padding-left:1em;margin:0">goldish</p>
золотистый фазан	<p style="padding-left:1em;margin:0">macartney</p>
золотить	<b>золот<u class="accent">и</u>ть</b><br/><font color="green">(</font><i class="p"><font color="green">что-л.</font></i><font color="green">)</font> <i class="p"><font color="green">несовер.</font></i> <font color="green">– золотить;</font> <i class="p"><font color="green">совер.</font></i> <font color="green">– позолотить, вызолотить</font><p style="padding-left:1em;margin:0">gild</p>
золотник	<b>золотн<u class="accent">и</u>к</b><br/><b>I</b> <object type="audio/x-wav" data="05150.wav" width="40" height="40"><param name="autoplay" value="false" /></object><br/><i class="p"><font color="green">м.р.</font></i><font color="green">;</font> <i class="p"><font color="green">уст.</font></i><p style="padding-left:1em;margin:0"><i>(русская мера веса, равная 1/96 фунта или 4,26 г <i class="p"><font color="green">||</font></i> old Russian measure of weight, equivalent to 1/96 of Russian pound)</i><br/> zolotnik</p><br/><b>II</b> <i class="p"><font color="green">м.р.</font></i><font color="green">;</font> <i class="p"><font color="green">тех.</font></i><p style="padding-left:1em;margin:0">valve, slide</p>
золото	<b>з<u class="accent">о</u>лото</b><br/><object type="audio/x-wav" data="05151.wav" width="40" height="40"><param name="autoplay" value="false" /></object><br/><i class="p"><font color="green">c.р.</font></i><p style="padding-left:1em;margin:0"><font color="brown">1)</font> gold; or</p><p style="padding-left:2em;margin:0"><span class="sec"><span class="ex"><font color="steelblue">не все золото, что блестит — <i class="p"><font color="green">посл.</font></i> all is not gold that glitters</font></span></span></p><p style="padding-left:2em;margin:0"><span class="sec">- <a href="bword://содержащий золото">содержащий золото</a></span></p><p style="padding-left:2em;margin:0"><span class="sec">- <a href="bword://россыпное золото">россыпное золото</a></span></p><p style="padding-left:2em;margin:0"><span class="sec">- <a href="bword://сусальное золото">сусальное золото</a></span></p><p style="padding-left:2em;margin:0"><span class="sec">- <a href="bword://червонное золото">червонное золото</a></span></p><p style="padding-left:2em;margin:0"><span class="sec">- <a href="bword://чистое золото">чистое золото</a></span></p><p style="padding-left:2em;margin:0"><span class="sec">- <a href="bword://самородное золото">самородное золото</a></span></p><p style="padding-left:2em;margin:0"><span class="sec">- <a href="bword://золото в слитках">золото в слитках</a></span></p><p style="padding-left:2em;margin:0"><span class="sec">- <a href="bword://добыча золота">добыча золота</a></span></p><p style="padding-left:2em;margin:0"><span class="sec">- <a href="bword://матовое золото">матовое золото</a></span></p><p style="padding-left:1em;margin:0"><font color="brown">2)</font> <i class="p"><font color="green">перен.</font></i> <i>(что-л. ценное)</i> gold</p><p style="padding-left:2em;margin:0"><span class="sec"><span class="ex"><font color="steelblue">она настоящее золото — she is pure gold</font></span></span></p>
золото в слитках	<p style="padding-left:1em;margin:0">gold bullion</p>
золотобит	<i class="p"><font color="green">м.р.</font></i><p style="padding-left:1em;margin:0">gold-beater</p>
золотовалютные резервы	<p style="padding-left:1em;margin:0">gold and exchange currency reserves, gold and foreign currency reserves</p>
золотоволосый	<b>золотовол<u class="accent">о</u>сый</b><br/><i class="p"><font color="green">прил.</font></i><p style="padding-left:1em;margin:0">golden-haired</p>
золотодобытчик	<b>золотодоб<u class="accent">ы</u>тчик</b><br/><i class="p"><font color="green">м.р.</font></i><p style="padding-left:1em;margin:0">gold-miner</p>
золотое дно	<p style="padding-left:1em;margin:0">gold(-)mine</p>
Золотое кольцо	<i class="p"><font color="green">c.р.</font></i><font color="green">;</font> <i class="p"><font color="green">геогр.</font></i><p style="padding-left:1em;margin:0">the Golden Ring <i>(a group of ancient Russian towns to the north-east from Moscow)</i></p>
золотое руно	<i class="p"><font color="green">миф.</font></i><p style="padding-left:1em;margin:0">the Golden Fleece</p>
золотое сечение	<i class="p"><font color="green">%%</font></i> <font color="green">;</font> <i class="p"><font color="green">иск.</font></i><p style="padding-left:1em;margin:0">golden section</p>
золотоискатель	<b>золотоиск<u class="accent">а</u>тель</b><br/><i class="p"><font color="green">м.р.</font></i><p style="padding-left:1em;margin:0">gold digger; gold-prospector</p>
золотой	<b>золот<u class="accent">о</u>й</b><br/><p style="padding-left:1em;margin:0"><b>1.</b> <object type="audio/x-wav" data="05152.wav" width="40" height="40"><param name="autoplay" value="false" /></object><br/><i class="p"><font color="green">прил.</font></i></p><p style="padding-left:1em;margin:0"><font color="brown">1)</font> gold(en); or</p><p style="padding-left:2em;margin:0"><span class="sec"><span class="ex"><font color="steelblue">сулить золотые горы — to promise wonders, to promise the moon / earth</font></span></span></p><p style="padding-left:2em;margin:0"><span class="sec"><span class="ex"><font color="steelblue">золотая середина — the golden mean</font></span></span></p><p style="padding-left:2em;margin:0"><span class="sec">- <a href="bword://золотой запас">золотой запас</a></span></p><p style="padding-left:2em;margin:0"><span class="sec">- <a href="bword://золотой песок">золотой песок</a></span></p><p style="padding-left:2em;margin:0"><span class="sec">- <a href="bword://золотой призер">золотой призер</a></span></p><p style="padding-left:2em;margin:0"><span class="sec">- <a href="bword://золотые промыслы">золотые промыслы</a></span></p><p style="padding-left:2em;margin:0"><span class="sec">- <a href="bword://золотой фонд">золотой фонд</a></span></p><p style="padding-left:2em;margin:0"><span class="sec">- <a href="bword://золотой телец">золотой телец</a></span></p><p style="padding-left:2em;margin:0"><span class="sec">- <a href="bword://золотое сечение">золотое сечение</a></span></p><p style="padding-left:2em;margin:0"><span class="sec">- <a href="bword://золотая фольга">золотая фольга</a></span></p><p style="padding-left:2em;margin:0"><span class="sec">- <a href="bword://золотая валюта">золотая валюта</a></span></p><p style="padding-left:2em;margin:0"><span class="sec">- <a href="bword://золотое дно">золотое дно</a></span></p><p style="padding-left:1em;margin:0"><font color="brown">2)</font> <i class="p"><font color="green">перен.</font></i><br/> dear, precious, invaluable</p><p style="padding-left:1em;margin:0"><span class="sec">•</span></p><p style="padding-left:1em;margin:0"><span class="sec"><span class="ex"><font color="steelblue">у него золотые руки — he is a handy man</font></span></span></p><p style="padding-left:1em;margin:0">- <a href="bword://золотой век">золотой век</a></p><p style="padding-left:1em;margin:0">- <a href="bword://золотая молодежь">золотая молодежь</a></p><p style="padding-left:1em;margin:0">- <a href="bword://золотые руки">золотые руки</a></p><p style="padding-left:1em;margin:0">- <a href="bword://золотая середина">золотая середина</a></p><p style="padding-left:1em;margin:0"><b>2.</b> <i class="p"><font color="green">м.р.</font></i><font color="green">;</font> <i class="p"><font color="green">скл. как прил.</font></i></p><p style="padding-left:1em;margin:0">gold coin</p>
Золотой Берег	<i class="p"><font color="green">м.р.</font></i><font color="green">;</font> <i class="p"><font color="green">геогр.</font></i><p style="padding-left:1em;margin:0"><font color="brown">1)</font> <i>(город)</i> Gold Coast</p><p style="padding-left:1em;margin:0"><font color="brown">2)</font> <i class="p"><font color="green">ист.</font></i> the Gold Coast <i class="p"><font color="green">см.</font></i> <a href="bword://Гана">Гана</a></p>
золотой век	<p style="padding-left:1em;margin:0">the Golden Age</p>
золотой запас	<i class="p"><font color="green">эк.</font></i><p style="padding-left:1em;margin:0">gold reserves <i class="p"><font color="green">мн.</font></i></p>
золотой песок	<p style="padding-left:1em;margin:0">gold dust, gold-dust, gravel, lead, wash</p>
золотой призер	<p style="padding-left:1em;margin:0">gold medallist</p>
золотой прииск	<p style="padding-left:1em;margin:0">gold-field, gold mine</p>
Золотой Рог	<i class="p"><font color="green">м.р.</font></i><font color="green">;</font> <i class="p"><font color="green">геогр.</font></i><p style="padding-left:1em;margin:0"><i>(бухта)</i> the Golden Horn</p>
золотой рудник	<p style="padding-left:1em;margin:0">gold-mine</p>
золотой телец	<p style="padding-left:1em;margin:0">the golden calf</p>
золотой фонд	<p style="padding-left:1em;margin:0">gold reserves; gold fund, fund / stock of gold; <i class="p"><font color="green">перен.</font></i> capital, most valuable possession</p>
золотоносная жила	<p style="padding-left:1em;margin:0">vein of gold, gold vein</p>
золотоносный	<b>золотон<u class="accent">о</u>сный</b><br/><i class="p"><font color="green">прил.</font></i><p style="padding-left:1em;margin:0">gold-bearing; auriferous <i class="p"><font color="green">научн.</font></i></p><p style="padding-left:2em;margin:0"><span class="sec">- <a href="bword://золотоносная жила">золотоносная жила</a></span></p>
золотоносный песок	<span class="sec"><b>See:</b></span><br/><span class="sec"><a href="bword://золотой песок">золотой песок</a></span>
золотоносный район	<p style="padding-left:1em;margin:0">gold-field</p>
золотопромышленник	<b>золотопром<u class="accent">ы</u>шленник</b><br/><i class="p"><font color="green">м.р.</font></i><p style="padding-left:1em;margin:0"><font color="brown">1)</font> gold-miner</p><p style="padding-left:1em;margin:0"><font color="brown">2)</font> owner of gold-mines</p>
золотопромышленность	<b>золотопром<u class="accent">ы</u>шленность</b><br/><i class="p"><font color="green">ж.р.</font></i><p style="padding-left:1em;margin:0">gold mining</p><p style="padding-left:2em;margin:0"><span class="sec"><b>Syn:</b></span></p><p style="padding-left:2em;margin:0"><span class="sec">добыча золота</span></p>
золотопромышленный	<b>золотопром<u class="accent">ы</u>шленный</b><br/><i class="p"><font color="green">прил.</font></i><p style="padding-left:1em;margin:0">gold-mining</p>
золотосодержащий	<b>золотосодерж<u class="accent">а</u>щий</b><br/><i class="p"><font color="green">прил.</font></i><p style="padding-left:1em;margin:0">auriferous, gold-bearing</p>
золототысячник	<b>золотот<u class="accent">ы</u>сячник</b><br/><i class="p"><font color="green">м.р.</font></i><font color="green">;</font> <i class="p"><font color="green">бот.</font></i><p style="padding-left:1em;margin:0">centaury</p>
золотошвейный	<b>золотошв<u class="accent">е</u>йный</b><br/><i class="p"><font color="green">прил.</font></i><p style="padding-left:1em;margin:0">gold-embroidery</p>
золотуха	<b>золот<u class="accent">у</u>ха</b><br/><i class="p"><font color="green">ж.р.</font></i><p style="padding-left:1em;margin:0">scrofula</p>
золотушный	<b>золот<u class="accent">у</u>шный</b><br/><i class="p"><font color="green">прил.</font></i><p style="padding-left:1em;margin:0">scrofulous</p>
Золотые Ворота	<i class="p"><font color="green">геогр.</font></i><p style="padding-left:1em;margin:0"><i>(пролив)</i> the Golden Gate</p>
золотые промыслы	<p style="padding-left:1em;margin:0">gold-fields, gold-mines</p>
золотые руки	<p style="padding-left:1em;margin:0">skilful / clever fingers, magical hands</p>
золочение	<b>золоч<u class="accent">е</u>ние</b><br/><i class="p"><font color="green">c.р.</font></i><p style="padding-left:1em;margin:0">gilding</p>
золоченый	<font color="green">(золочёный)</font> <i class="p"><font color="green">прил.</font></i><font color="green">;</font> <i class="p"><font color="green">прич.</font></i> <i class="p"><font color="green">от</font></i> <a href="bword://золотить">золотить</a><p style="padding-left:1em;margin:0">gilt, gilded</p>
золушка	<b>з<u class="accent">о</u>лушка</b><br/><i class="p"><font color="green">ж.р.</font></i><p style="padding-left:1em;margin:0">Cinderella</p>
золь	<i class="p"><font color="green">м.р.</font></i><font color="green">;</font> <i class="p"><font color="green">хим.</font></i><p style="padding-left:1em;margin:0">sol</p>
зольник	<b>з<u class="accent">о</u>льник</b><br/><i class="p"><font color="green">м.р.</font></i><font color="green">;</font> <i class="p"><font color="green">тех.</font></i><p style="padding-left:1em;margin:0">ashpit</p>
Зомба	<b>З<u class="accent">о</u>мба</b><br/><i class="p"><font color="green">ж.р.</font></i><font color="green">;</font> <i class="p"><font color="green">геогр.</font></i><p style="padding-left:1em;margin:0">Zomba</p>
зомби	<b>з<u class="accent">о</u>мби</b><br/><i class="p"><font color="green">м.р.</font></i><p style="padding-left:1em;margin:0">zombi(e)</p>
зона	<b>з<u class="accent">о</u>на</b><br/><object type="audio/x-wav" data="05153.wav" width="40" height="40"><param name="autoplay" value="false" /></object><br/><i class="p"><font color="green">ж.р.</font></i><p style="padding-left:1em;margin:0">zone</p><p style="padding-left:2em;margin:0"><span class="sec">- <a href="bword://зона безопасности">зона безопасности</a></span></p><p style="padding-left:2em;margin:0"><span class="sec">- <a href="bword://зона молчания">зона молчания</a></span></p><p style="padding-left:2em;margin:0"><span class="sec">- <a href="bword://глубоководная зона">глубоководная зона</a></span></p><p style="padding-left:2em;margin:0"><span class="sec">- <a href="bword://безъядерная зона">безъядерная зона</a></span></p><p style="padding-left:2em;margin:0"><span class="sec">- <a href="bword://буферная зона">буферная зона</a></span></p>
зона безопасности	<p style="padding-left:1em;margin:0">safe haven</p>
зона защиты	<p style="padding-left:1em;margin:0">zone defence, back-court, end-zone</p>
зона молчания	<p style="padding-left:1em;margin:0"><i class="p"><font color="green">радио</font></i> dead-spot, blind spot, acoustic shadow</p>
зональный	<b>зон<u class="accent">а</u>льный</b><br/><i class="p"><font color="green">прил.</font></i><p style="padding-left:1em;margin:0">zonal; zone</p>
зонд	<object type="audio/x-wav" data="05154.wav" width="40" height="40"><param name="autoplay" value="false" /></object><br/><i class="p"><font color="green">м.р.</font></i><p style="padding-left:1em;margin:0"><font color="brown">1)</font> <i class="p"><font color="green">мед.</font></i><br/> probe</p><p style="padding-left:2em;margin:0"><span class="sec">- <a href="bword://желудочный зонд">желудочный зонд</a></span></p><p style="padding-left:1em;margin:0"><font color="brown">2)</font> <i class="p"><font color="green">геол.</font></i><br/> bore</p><p style="padding-left:1em;margin:0"><font color="brown">3)</font> weather-balloon, sonde</p>
зондаж	<b>зонд<u class="accent">а</u>ж</b><br/><i class="p"><font color="green">м.р.</font></i><p style="padding-left:1em;margin:0">trial balloon, overture</p><p style="padding-left:2em;margin:0"><span class="sec"><b>Syn:</b></span></p><p style="padding-left:2em;margin:0"><span class="sec"><a href="bword://пробный шар">пробный шар</a></span></p>
зондирование	<b>зонд<u class="accent">и</u>рование</b><br/><i class="p"><font color="green">c.р.</font></i><p style="padding-left:1em;margin:0">probe, reconnaissance, sounding</p>
зондировать	<b>зонд<u class="accent">и</u>ровать</b><br/><font color="green">(</font><i class="p"><font color="green">что-л.</font></i><font color="green">)</font> <i class="p"><font color="green">несовер.</font></i><p style="padding-left:1em;margin:0">sound, probe</p><p style="padding-left:1em;margin:0"><span class="sec">•</span></p><p style="padding-left:1em;margin:0">- <a href="bword://зондировать почву">зондировать почву</a></p>
зондировать почву	<p style="padding-left:1em;margin:0">to explore / test the ground</p>
Зондские острова	<i class="p"><font color="green">мн.</font></i><font color="green">;</font> <i class="p"><font color="green">геогр.</font></i><p style="padding-left:1em;margin:0">the Sunda Islands</p>
Зондский пролив	<i class="p"><font color="green">м.р.</font></i><font color="green">;</font> <i class="p"><font color="green">геогр.</font></i><p style="padding-left:1em;margin:0">the Sunda Strait</p>
зонт	<object type="audio/x-wav" data="05155.wav" width="40" height="40"><param name="autoplay" value="false" /></object><br/><i class="p"><font color="green">м.р.</font></i><p style="padding-left:1em;margin:0">umbrella; sunshade, parasol; awning <i>(навес)</i></p>
зонтик	<b>з<u class="accent">о</u>нтик</b><br/><object type="audio/x-wav" data="05156.wav" width="40" height="40"><param name="autoplay" value="false" /></object><br/><i class="p"><font color="green">м.р.</font></i><p style="padding-left:1em;margin:0"><font color="brown">1)</font> <i class="p"><font color="green">см.</font></i> <a href="bword://зонт">зонт</a></p><p style="padding-left:1em;margin:0"><font color="brown">2)</font> <i class="p"><font color="green">бот.</font></i><br/> umbel</p>
зонтичная антенна	<p style="padding-left:1em;margin:0">umbrella antenna, umbrella aerial</p>
зонтичный	<i class="p"><font color="green">прил.</font></i><font color="green">;</font> <i class="p"><font color="green">бот.</font></i><p style="padding-left:1em;margin:0">umbellate, umbelliferous</p>
зоогеография	<b>зоогеогр<u class="accent">а</u>фия</b><br/><i class="p"><font color="green">ж.р.</font></i><p style="padding-left:1em;margin:0">zoogeography</p>
зоолог	<b>зо<u class="accent">о</u>лог</b><br/><object type="audio/x-wav" data="05157.wav" width="40" height="40"><param name="autoplay" value="false" /></object><br/><i class="p"><font color="green">м.р.</font></i><p style="padding-left:1em;margin:0">zoologist</p>
зоологический	<b>зоолог<u class="accent">и</u>ческий</b><br/><object type="audio/x-wav" data="05158.wav" width="40" height="40"><param name="autoplay" value="false" /></object><br/><i class="p"><font color="green">прил.</font></i><p style="padding-left:1em;margin:0">zoological; brutish, bestial <i class="p"><font color="green">перен.</font></i></p><p style="padding-left:1em;margin:0"><span class="sec">•</span></p><p style="padding-left:1em;margin:0"><span class="sec"><span class="ex"><font color="steelblue">зоологический сад — zoological gardens <i class="p"><font color="green">мн.</font></i>; zoo</font></span></span></p>
зоологический сад	<p style="padding-left:1em;margin:0">zoological gardens <i class="p"><font color="green">мн.</font></i>, zoo</p>
зоология	<b>зоол<u class="accent">о</u>гия</b><br/><object type="audio/x-wav" data="05159.wav" width="40" height="40"><param name="autoplay" value="false" /></object><br/><i class="p"><font color="green">ж.р.</font></i><p style="padding-left:1em;margin:0">zoology</p>
зоомагазин	<b>зоомагаз<u class="accent">и</u>н</b><br/><i class="p"><font color="green">м.р.</font></i><p style="padding-left:1em;margin:0">pet-shop</p>
зооморфизм	<b>зооморф<u class="accent">и</u>зм</b><br/><i class="p"><font color="green">м.р.</font></i><p style="padding-left:1em;margin:0">zoomorphism</p>
зоопарк	<b>зооп<u class="accent">а</u>рк</b><br/><object type="audio/x-wav" data="05160.wav" width="40" height="40"><param name="autoplay" value="false" /></object><br/><i class="p"><font color="green">м.р.</font></i><p style="padding-left:1em;margin:0">zoological gardens <i class="p"><font color="green">мн.</font></i>; zoo</p>
зоопланктон	<b>зоопланкт<u class="accent">о</u>н</b><br/><i class="p"><font color="green">м.р.</font></i><p style="padding-left:1em;margin:0">animal plankton</p>
зоопсихология	<b>зоопсихол<u class="accent">о</u>гия</b><br/><i class="p"><font color="green">ж.р.</font></i><p style="padding-left:1em;margin:0">animal psychology</p>
зоосад	<font color="green">=</font> <a href="bword://зоопарк">зоопарк</a>
зоотехника	<b>зоот<u class="accent">е</u>хника</b><br/><i class="p"><font color="green">ж.р.</font></i><p style="padding-left:1em;margin:0">zooculture, zootechnics</p>
зоофит	<i class="p"><font color="green">м.р.</font></i><font color="green">;</font> <i class="p"><font color="green">биол.</font></i><p style="padding-left:1em;margin:0">zoophyte</p>
зоохимический	<b>зоохим<u class="accent">и</u>ческий</b><br/><i class="p"><font color="green">прил.</font></i><p style="padding-left:1em;margin:0">zoochemical</p>
зоохимия	<b>зоох<u class="accent">и</u>мия</b><br/><i class="p"><font color="green">ж.р.</font></i><p style="padding-left:1em;margin:0">zoochemistry</p>
зоркий	<b>з<u class="accent">о</u>ркий</b><br/><object type="audio/x-wav" data="05161.wav" width="40" height="40"><param name="autoplay" value="false" /></object><br/><i class="p"><font color="green">прил.</font></i><p style="padding-left:1em;margin:0"><font color="brown">1)</font> sharp-sighted</p><p style="padding-left:1em;margin:0"><font color="brown">2)</font> <i>(бдительный)</i><br/> observant, watchful, vigilant</p>
зорко	<b>з<u class="accent">о</u>рко</b><br/><p style="padding-left:1em;margin:0"><i class="p"><font color="green">нареч.</font></i></p><p style="padding-left:2em;margin:0"><span class="sec"><b>See:</b></span></p><p style="padding-left:2em;margin:0"><span class="sec"><a href="bword://зоркий">зоркий</a></span></p>
зорко следить	<p style="padding-left:1em;margin:0">be on the alert <i>(for)</i></p>
зорька	<i class="p"><font color="green">уменьш.</font></i> <i class="p"><font color="green">от</font></i> <a href="bword://заря">заря</a> 1)
зрачковый	<b>зрачк<u class="accent">о</u>вый</b><br/><i class="p"><font color="green">прил.</font></i><p style="padding-left:1em;margin:0">pupil(l)ary</p>
зрачковый рефлекс	<p style="padding-left:1em;margin:0">iris contraction reflex</p>
зрачок	<b>зрач<u class="accent">о</u>к</b><br/><object type="audio/x-wav" data="05162.wav" width="40" height="40"><param name="autoplay" value="false" /></object><br/><i class="p"><font color="green">м.р.</font></i><p style="padding-left:1em;margin:0">pupil (of the eye)</p>
зрелище	<b>зр<u class="accent">е</u>лище</b><br/><object type="audio/x-wav" data="05163.wav" width="40" height="40"><param name="autoplay" value="false" /></object><br/><i class="p"><font color="green">c.р.</font></i><p style="padding-left:1em;margin:0">sight, spectacle; show <i class="p"><font color="green">разг.</font></i>; performance <i>(представление)</i></p><p style="padding-left:2em;margin:0"><span class="sec"><span class="ex"><font color="steelblue">представлять собой жалкое зрелище — to present / look a sorry spectacle, to be a sorry sight</font></span></span></p><p style="padding-left:2em;margin:0"><span class="sec"><span class="ex"><font color="steelblue">яркое зрелище — eye-catcher</font></span></span></p><p style="padding-left:2em;margin:0"><span class="sec">- <a href="bword://феерическое зрелище">феерическое зрелище</a></span></p><p style="padding-left:2em;margin:0"><span class="sec">- <a href="bword://умилительное зрелище">умилительное зрелище</a></span></p><p style="padding-left:2em;margin:0"><span class="sec">- <a href="bword://увлекательное зрелище">увлекательное зрелище</a></span></p><p style="padding-left:2em;margin:0"><span class="sec">- <a href="bword://тяжелое зрелище">тяжелое зрелище</a></span></p><p style="padding-left:2em;margin:0"><span class="sec">- <a href="bword://тягостное зрелище">тягостное зрелище</a></span></p><p style="padding-left:2em;margin:0"><span class="sec">- <a href="bword://трагическое зрелище">трагическое зрелище</a></span></p><p style="padding-left:2em;margin:0"><span class="sec">- <a href="bword://жалкое зрелище">жалкое зрелище</a></span></p>
зрелищный	<object type="audio/x-wav" data="05164.wav" width="40" height="40"><param name="autoplay" value="false" /></object><br/><i class="p"><font color="green">прил.</font></i> <i class="p"><font color="green">от</font></i> <a href="bword://зрелище">зрелище</a>
зрелость	<b>зр<u class="accent">е</u>лость</b><br/><object type="audio/x-wav" data="05165.wav" width="40" height="40"><param name="autoplay" value="false" /></object><br/><i class="p"><font color="green">ж.р.</font></i><p style="padding-left:1em;margin:0">ripeness, maturity</p><p style="padding-left:1em;margin:0"><span class="sec">•</span></p><p style="padding-left:1em;margin:0"><span class="sec"><span class="ex"><font color="steelblue">экзамен на аттестат зрелости — examination for the school-leaving certificate</font></span></span></p><p style="padding-left:1em;margin:0">- <a href="bword://аттестат зрелости">аттестат зрелости</a></p><p style="padding-left:1em;margin:0">- <a href="bword://половая зрелость">половая зрелость</a></p>
зрелый	<b>зр<u class="accent">е</u>лый</b><br/><object type="audio/x-wav" data="05166.wav" width="40" height="40"><param name="autoplay" value="false" /></object><br/><i class="p"><font color="green">прил.</font></i><p style="padding-left:1em;margin:0">ripe, mature; deliberate</p><p style="padding-left:2em;margin:0"><span class="sec"><span class="ex"><font color="steelblue">достигать зрелого возраста — arrive at manhood</font></span></span></p><p style="padding-left:2em;margin:0"><span class="sec">- <a href="bword://в зрелом возрасте">в зрелом возрасте</a></span></p>
зрение	<b>зр<u class="accent">е</u>ние</b><br/><object type="audio/x-wav" data="05167.wav" width="40" height="40"><param name="autoplay" value="false" /></object><br/><i class="p"><font color="green">c.р.</font></i><p style="padding-left:1em;margin:0">(eye)sight; vision <i class="p"><font color="green">мед.</font></i></p><p style="padding-left:2em;margin:0"><span class="sec"><span class="ex"><font color="steelblue">плохое зрение — poor eyesight</font></span></span></p><p style="padding-left:2em;margin:0"><span class="sec"><span class="ex"><font color="steelblue">потеря зрения — loss of sight</font></span></span></p><p style="padding-left:2em;margin:0"><span class="sec"><span class="ex"><font color="steelblue">портить свое зрение — to ruin one's eyesight</font></span></span></p><p style="padding-left:2em;margin:0"><span class="sec"><span class="ex"><font color="steelblue">хорошее зрение — good eyesight</font></span></span></p><p style="padding-left:2em;margin:0"><span class="sec">- <a href="bword://терять зрение">терять зрение</a></span></p><p style="padding-left:2em;margin:0"><span class="sec">- <a href="bword://острое зрение">острое зрение</a></span></p><p style="padding-left:1em;margin:0"><span class="sec">•</span></p><p style="padding-left:1em;margin:0"><span class="sec"><span class="ex"><font color="steelblue">с точки зрения, под углом зрения — from the point of view, from the standpoint</font></span></span></p><p style="padding-left:1em;margin:0"><span class="sec"><span class="ex"><font color="steelblue">поле зрения — range of vision, eyeshot; horizon <i class="p"><font color="green">перен.</font></i>; field of vision</font></span></span></p><p style="padding-left:1em;margin:0">- <a href="bword://угол зрения">угол зрения</a></p><p style="padding-left:1em;margin:0">- <a href="bword://точка зрения">точка зрения</a></p>
зреть	<object type="audio/x-wav" data="05168.wav" width="40" height="40"><param name="autoplay" value="false" /></object><br/><i class="p"><font color="green">несовер.</font></i> <font color="green">– зреть;</font> <i class="p"><font color="green">совер.</font></i> <font color="green">– созреть, вызреть</font> <i class="p"><font color="green">без доп.</font></i><p style="padding-left:1em;margin:0">ripen; mature <i class="p"><font color="green">перен.</font></i></p>
зримый	<b>зр<u class="accent">и</u>мый</b><br/><i class="p"><font color="green">прил.</font></i><p style="padding-left:1em;margin:0">visible</p>
зритель	<b>зр<u class="accent">и</u>тель</b><br/><object type="audio/x-wav" data="05169.wav" width="40" height="40"><param name="autoplay" value="false" /></object><br/><i class="p"><font color="green">м.р.</font></i><p style="padding-left:1em;margin:0"><font color="brown">1)</font> spectator, onlooker, viewer; gazer, looker, looker-on <i>(наблюдатель)</i></p><p style="padding-left:2em;margin:0"><span class="sec"><span class="ex"><font color="steelblue">театр юного зрителя — young people's theatre</font></span></span></p><p style="padding-left:1em;margin:0"><font color="brown">2)</font> <i class="p"><font color="green">мн.</font></i> зрители; <i class="p"><font color="green">собир.</font></i> <i>(публика, аудитория)</i><br/> audience, house, attendance, the dedans</p><p style="padding-left:2em;margin:0"><span class="sec"><span class="ex"><font color="steelblue">1000 зрителей — audience of 1000</font></span></span></p>
зрительная память	<p style="padding-left:1em;margin:0"><i class="p"><font color="green">мед.</font></i> visual memory; camera eye <i class="p"><font color="green">амер.</font></i></p>
зрительная труба	<p style="padding-left:1em;margin:0">spyglass</p>
зрительница	<b>зр<u class="accent">и</u>тельница</b><br/><i class="p"><font color="green">ж.р.</font></i><p style="padding-left:1em;margin:0">spectatress</p>
зрительный	<b>зр<u class="accent">и</u>тельный</b><br/><object type="audio/x-wav" data="05170.wav" width="40" height="40"><param name="autoplay" value="false" /></object><br/><i class="p"><font color="green">прил.</font></i><p style="padding-left:1em;margin:0">visual, optic, optical</p><p style="padding-left:2em;margin:0"><span class="sec">- <a href="bword://зрительный зал">зрительный зал</a></span></p><p style="padding-left:2em;margin:0"><span class="sec">- <a href="bword://зрительная труба">зрительная труба</a></span></p>
зрительный зал	<p style="padding-left:1em;margin:0">hall, auditorium</p>
зрительский	<i class="p"><font color="green">прил.</font></i> <i class="p"><font color="green">от</font></i> <a href="bword://зритель">зритель</a>
зря	<object type="audio/x-wav" data="05171.wav" width="40" height="40"><param name="autoplay" value="false" /></object><br/><i class="p"><font color="green">нареч.</font></i><font color="green">;</font> <i class="p"><font color="green">разг.</font></i><p style="padding-left:1em;margin:0">in vain, to no purpose, (all) for nothing</p>
зрячий	<b>зр<u class="accent">я</u>чий</b><br/><p style="padding-left:1em;margin:0"><b>1.</b> <i class="p"><font color="green">прил.</font></i></p><p style="padding-left:1em;margin:0">able to see, sighted</p><p style="padding-left:1em;margin:0"><b>2.</b> <i class="p"><font color="green">м.р.</font></i><font color="green">;</font> <i class="p"><font color="green">скл. как прил.</font></i></p><p style="padding-left:1em;margin:0">sighted person</p>
зуав	<b>зу<u class="accent">а</u>в</b><br/><i class="p"><font color="green">м.р.</font></i><font color="green">;</font> <i class="p"><font color="green">воен.</font></i><font color="green">;</font> <i class="p"><font color="green">ист.</font></i><p style="padding-left:1em;margin:0">zouave</p>
зуб	<object type="audio/x-wav" data="05172.wav" width="40" height="40"><param name="autoplay" value="false" /></object><br/><i class="p"><font color="green">м.р.</font></i><p style="padding-left:1em;margin:0"><font color="brown">1)</font> tooth; <i class="p"><font color="green">мн.</font></i> grinder <i class="p"><font color="green">шутл.</font></i>; ivory <i class="p"><font color="green">сленг</font></i></p><p style="padding-left:2em;margin:0"><span class="sec"><span class="ex"><font color="steelblue">дать кому-л. в зубы — to give smb. a smack in the teeth</font></span></span></p><p style="padding-left:2em;margin:0"><span class="sec"><span class="ex"><font color="steelblue">вставлять себе зубы — to have a denture made</font></span></span></p><p style="padding-left:2em;margin:0"><span class="sec"><span class="ex"><font color="steelblue">имеющий форму зуба — dentiform</font></span></span></p><p style="padding-left:2em;margin:0"><span class="sec"><span class="ex"><font color="steelblue">ядовитый зуб — <i>(змеи)</i> fang</font></span></span></p><p style="padding-left:2em;margin:0"><span class="sec"><span class="ex"><font color="steelblue">шатающийся зуб — loose tooth</font></span></span></p><p style="padding-left:2em;margin:0"><span class="sec">- <a href="bword://искусственный зуб">искусственный зуб</a></span></p><p style="padding-left:2em;margin:0"><span class="sec">- <a href="bword://задний зуб">задний зуб</a></span></p><p style="padding-left:2em;margin:0"><span class="sec">- <a href="bword://передний зуб">передний зуб</a></span></p><p style="padding-left:2em;margin:0"><span class="sec">- <a href="bword://корень зуба">корень зуба</a></span></p><p style="padding-left:2em;margin:0"><span class="sec">- <a href="bword://глазной зуб">глазной зуб</a></span></p><p style="padding-left:2em;margin:0"><span class="sec">- <a href="bword://лечение зубов">лечение зубов</a></span></p><p style="padding-left:2em;margin:0"><span class="sec">- <a href="bword://молочный зуб">молочный зуб</a></span></p><p style="padding-left:2em;margin:0"><span class="sec">- <a href="bword://коренной зуб">коренной зуб</a></span></p><p style="padding-left:2em;margin:0"><span class="sec">- <a href="bword://зуб мудрости">зуб мудрости</a></span></p><p style="padding-left:2em;margin:0"><span class="sec">- <a href="bword://вставные зубы">вставные зубы</a></span></p><p style="padding-left:2em;margin:0"><span class="sec">- <a href="bword://щелканье зубами">щелканье зубами</a></span></p><p style="padding-left:2em;margin:0"><span class="sec">- <a href="bword://хрустеть на зубах">хрустеть на зубах</a></span></p><p style="padding-left:2em;margin:0"><span class="sec">- <a href="bword://фальшивые зубы">фальшивые зубы</a></span></p><p style="padding-left:2em;margin:0"><span class="sec">- <a href="bword://удалять зуб">удалять зуб</a></span></p><p style="padding-left:2em;margin:0"><span class="sec">- <a href="bword://скрипеть зубами">скрипеть зубами</a></span></p><p style="padding-left:2em;margin:0"><span class="sec">- <a href="bword://скрежет зубов">скрежет зубов</a></span></p><p style="padding-left:2em;margin:0"><span class="sec">- <a href="bword://сжимать зубы">сжимать зубы</a></span></p><p style="padding-left:2em;margin:0"><span class="sec">- <a href="bword://стискивать зубы">стискивать зубы</a></span></p><p style="padding-left:2em;margin:0"><span class="sec">- <a href="bword://дергать зуб">дергать зуб</a></span></p><p style="padding-left:2em;margin:0"><span class="sec">- <a href="bword://вязнуть в зубах">вязнуть в зубах</a></span></p><p style="padding-left:2em;margin:0"><span class="sec">- <a href="bword://верхний зуб">верхний зуб</a></span></p><p style="padding-left:2em;margin:0"><span class="sec">- <a href="bword://до зубов">до зубов</a></span></p><p style="padding-left:2em;margin:0"><span class="sec">- <a href="bword://молочные зубы">молочные зубы</a></span></p><p style="padding-left:2em;margin:0"><span class="sec">- <a href="bword://постоянные зубы">постоянные зубы</a></span></p><p style="padding-left:1em;margin:0"><font color="brown">2)</font> <i class="p"><font color="green">тех.</font></i><br/> cog, dent</p><p style="padding-left:1em;margin:0"><span class="sec">•</span></p><p style="padding-left:1em;margin:0"><span class="sec"><span class="ex"><font color="steelblue">положить зубы на полку <i class="p"><font color="green">разг.</font></i> — to tighten one's belt</font></span></span></p><p style="padding-left:1em;margin:0"><span class="sec"><span class="ex"><font color="steelblue">держаться зубами за что-л. <i class="p"><font color="green">разг.</font></i> — to hold on to smth. like grim death, to hold on to smth. with all one's strength</font></span></span></p><p style="padding-left:1em;margin:0"><span class="sec"><span class="ex"><font color="steelblue">дареному коню в зубы не смотрят <i class="p"><font color="green">посл.</font></i> — one shouldn't look a gift horse in the mouth</font></span></span></p><p style="padding-left:1em;margin:0"><span class="sec"><span class="ex"><font color="steelblue">ломать зубы на чем-л. — to come to grief over smth.</font></span></span></p><p style="padding-left:1em;margin:0">- <a href="bword://заговаривать зубы">заговаривать зубы</a></p><p style="padding-left:1em;margin:0">- <a href="bword://держать язык за зубами">держать язык за зубами</a></p><p style="padding-left:1em;margin:0">- <a href="bword://не по зубам">не по зубам</a></p><p style="padding-left:1em;margin:0">- <a href="bword://сквозь зубы">сквозь зубы</a></p><p style="padding-left:1em;margin:0">- <a href="bword://иметь зуб">иметь зуб</a></p><p style="padding-left:1em;margin:0">- <a href="bword://точить зуб">точить зуб</a></p>
зуб мудрости	<p style="padding-left:1em;margin:0">wisdom tooth</p>
зубастый	<b>зуб<u class="accent">а</u>стый</b><br/><i class="p"><font color="green">прил.</font></i><font color="green">;</font> <i class="p"><font color="green">разг.</font></i><p style="padding-left:1em;margin:0">large-toothed, sharp-toothed; sharp-tongued, biting, sarcastic <i class="p"><font color="green">перен.</font></i></p>
зубатка	<b>зуб<u class="accent">а</u>тка</b><br/><i class="p"><font color="green">ж.р.</font></i><font color="green">;</font> <i class="p"><font color="green">зоол.</font></i><p style="padding-left:1em;margin:0">lancet fish</p>
зубатый кит	<p style="padding-left:1em;margin:0">toothed whale</p>
зубец	<b>зуб<u class="accent">е</u>ц</b><br/><i class="p"><font color="green">м.р.</font></i><p style="padding-left:1em;margin:0"><font color="brown">1)</font> tooth; jag</p><p style="padding-left:1em;margin:0"><font color="brown">2)</font> <i class="p"><font color="green">мн.</font></i> <i>(стен, башен)</i><br/> battlement, merlon</p><p style="padding-left:1em;margin:0"><font color="brown">3)</font> <i class="p"><font color="green">мн.</font></i> <i>(фестоны платья)</i><br/> scallop</p>
зубило	<b>зуб<u class="accent">и</u>ло</b><br/><object type="audio/x-wav" data="05173.wav" width="40" height="40"><param name="autoplay" value="false" /></object><br/><i class="p"><font color="green">c.р.</font></i><font color="green">;</font> <i class="p"><font color="green">тех.</font></i><p style="padding-left:1em;margin:0">point-tool, chisel</p><p style="padding-left:2em;margin:0"><span class="sec">- <a href="bword://ручное зубило">ручное зубило</a></span></p>
зубная боль	<p style="padding-left:1em;margin:0">toothache</p>
зубная паста	<p style="padding-left:1em;margin:0">tooth-paste</p>
зубная щетка	<p style="padding-left:1em;margin:0">tooth-brush</p>
зубная эмаль	<i class="p"><font color="green">анат.</font></i><p style="padding-left:1em;margin:0">enamel</p>
зубной	<b>зубн<u class="accent">о</u>й</b><br/><object type="audio/x-wav" data="05174.wav" width="40" height="40"><param name="autoplay" value="false" /></object><br/><i class="p"><font color="green">прил.</font></i><p style="padding-left:1em;margin:0"><font color="brown">1)</font> tooth</p><p style="padding-left:2em;margin:0"><span class="sec"><span class="ex"><font color="steelblue">тюбик зубной пасты — tube of toothpaste</font></span></span></p><p style="padding-left:2em;margin:0"><span class="sec">- <a href="bword://зубной врач">зубной врач</a></span></p><p style="padding-left:2em;margin:0"><span class="sec">- <a href="bword://зубная боль">зубная боль</a></span></p><p style="padding-left:2em;margin:0"><span class="sec">- <a href="bword://зубной протез">зубной протез</a></span></p><p style="padding-left:2em;margin:0"><span class="sec">- <a href="bword://зубная щетка">зубная щетка</a></span></p><p style="padding-left:2em;margin:0"><span class="sec">- <a href="bword://зубной порошок">зубной порошок</a></span></p><p style="padding-left:2em;margin:0"><span class="sec">- <a href="bword://зубная паста">зубная паста</a></span></p><p style="padding-left:2em;margin:0"><span class="sec">- <a href="bword://зубной техник">зубной техник</a></span></p><p style="padding-left:2em;margin:0"><span class="sec">- <a href="bword://зубная эмаль">зубная эмаль</a></span></p><p style="padding-left:1em;margin:0"><font color="brown">2)</font> <i class="p"><font color="green">лингв.</font></i><br/> dental</p>
зубной врач	<p style="padding-left:1em;margin:0">dentist</p>
зубной порошок	<p style="padding-left:1em;margin:0">tooth-powder</p>
зубной протез	<p style="padding-left:1em;margin:0">denture, false tooth</p>
зубной согласный	<p style="padding-left:1em;margin:0">dental consonant</p>
зубной техник	<p style="padding-left:1em;margin:0">dental mechanic</p>
зубовидный	<i class="p"><font color="green">прил.</font></i><p style="padding-left:1em;margin:0">odontoid</p>
зубоврачебный	<b>зубоврач<u class="accent">е</u>бный</b><br/><i class="p"><font color="green">прил.</font></i><p style="padding-left:1em;margin:0">dental, stomatological</p><p style="padding-left:2em;margin:0"><span class="sec">- <a href="bword://зубоврачебный кабинет">зубоврачебный кабинет</a></span></p>
зубоврачебный кабинет	<p style="padding-left:1em;margin:0">dental surgery; dentist's office <i class="p"><font color="green">амер.</font></i></p>
зубок	<b>зуб<u class="accent">о</u>к</b><br/><i class="p"><font color="green">м.р.</font></i><p style="padding-left:1em;margin:0"><i>(луковичка)</i> bulbil</p><p style="padding-left:2em;margin:0"><span class="sec">- <a href="bword://зубок чеснока">зубок чеснока</a></span></p><p style="padding-left:1em;margin:0"><span class="sec">•</span></p><p style="padding-left:1em;margin:0"><span class="sec"><span class="ex"><font color="steelblue">он знал предмет на зубок — he knew the subject up and down</font></span></span></p>
зубок чеснока	<p style="padding-left:1em;margin:0">chive, chive garlic, clove, clove of garlic, garlic bulblet</p>
зубоскал	<b>зубоск<u class="accent">а</u>л</b><br/><i class="p"><font color="green">м.р.</font></i><font color="green">;</font> <i class="p"><font color="green">разг.</font></i><p style="padding-left:1em;margin:0">miocker, scoffer</p>
зубоскалить	<b>зубоск<u class="accent">а</u>лить</b><br/><i class="p"><font color="green">несовер.</font></i><font color="green">;</font> <i class="p"><font color="green">без доп.</font></i><font color="green">;</font> <i class="p"><font color="green">разг.</font></i><p style="padding-left:1em;margin:0">scoff, mock</p>
зубочистка	<b>зубоч<u class="accent">и</u>стка</b><br/><i class="p"><font color="green">ж.р.</font></i><p style="padding-left:1em;margin:0">toothpick</p>
зубр	<object type="audio/x-wav" data="05175.wav" width="40" height="40"><param name="autoplay" value="false" /></object><br/><i class="p"><font color="green">м.р.</font></i><p style="padding-left:1em;margin:0"><font color="brown">1)</font> bison</p><p style="padding-left:1em;margin:0"><font color="brown">2)</font> <i class="p"><font color="green">перен.</font></i>; <i class="p"><font color="green">разг.</font></i><br/> fossil</p>
зубрежка	<font color="green">(зубрёжка)</font> <i class="p"><font color="green">ж.р.</font></i><font color="green">;</font> <i class="p"><font color="green">разг.</font></i><p style="padding-left:1em;margin:0">cramming</p>
зубрила	<b>зубр<u class="accent">и</u>ла</b><br/><i class="p"><font color="green">м.р.</font></i><font color="green">;</font> <i class="p"><font color="green">ж.р.</font></i><font color="green">;</font> <i class="p"><font color="green">разг.</font></i><p style="padding-left:1em;margin:0">crammer</p>
зубрить	<b>зубр<u class="accent">и</u>ть</b><br/><b>I</b> <font color="green">(</font><i class="p"><font color="green">что-л.</font></i><font color="green">)</font> <i class="p"><font color="green">несовер.</font></i><font color="green">;</font> <i class="p"><font color="green">совер.</font></i> <font color="green">зазубрить, вызубрить;</font> <i class="p"><font color="green">разг.</font></i><p style="padding-left:1em;margin:0">cram, learn by rote</p><br/><b>II</b> <font color="green">(</font><i class="p"><font color="green">что-л.</font></i><font color="green">)</font> <i class="p"><font color="green">несовер.</font></i> <font color="green">– зубрить;</font> <i class="p"><font color="green">совер.</font></i> <font color="green">– зазубрить</font><p style="padding-left:1em;margin:0">notch, serrate</p>
зубровка	<b>зубр<u class="accent">о</u>вка</b><br/><i class="p"><font color="green">ж.р.</font></i><p style="padding-left:1em;margin:0"><font color="brown">1)</font> <i class="p"><font color="green">бот.</font></i><br/> sweet-grass</p><p style="padding-left:1em;margin:0"><font color="brown">2)</font> <i>(водочная настойка на травах <i class="p"><font color="green">||</font></i> sweet-grass vodka)</i><br/> zubrovka</p>
зубчатая передача	<i class="p"><font color="green">%%</font></i> <font color="green">;</font> <i class="p"><font color="green">тех.</font></i><p style="padding-left:1em;margin:0">gearing</p>
зубчатая рейка	<i class="p"><font color="green">%%</font></i> <font color="green">;</font> <i class="p"><font color="green">тех.</font></i><p style="padding-left:1em;margin:0">rack <i>(шестерни <i class="p"><font color="green">||</font></i> for a pinion)</i></p>
зубчатка	<b>зубч<u class="accent">а</u>тка</b><br/><i class="p"><font color="green">ж.р.</font></i><font color="green">;</font> <i class="p"><font color="green">тех.</font></i><p style="padding-left:1em;margin:0">rack-wheel</p>
зубчатое зацепление	<i class="p"><font color="green">%%</font></i> <font color="green">;</font> <i class="p"><font color="green">тех.</font></i><p style="padding-left:1em;margin:0">toothing</p>
зубчатое колесо	<p style="padding-left:1em;margin:0">cog-wheel</p>
зубчатость	<b>зубч<u class="accent">а</u>тость</b><br/><i class="p"><font color="green">ж.р.</font></i><font color="green">;</font> <i class="p"><font color="green">бот.</font></i><p style="padding-left:1em;margin:0">dentation, serration</p>
зубчатый	<object type="audio/x-wav" data="05176.wav" width="40" height="40"><param name="autoplay" value="false" /></object><br/><i class="p"><font color="green">прил.</font></i><p style="padding-left:1em;margin:0">toothed, cogged; indented, notched <i>(зазубренный)</i></p>
зубчик	<b>з<u class="accent">у</u>бчик</b><br/><i class="p"><font color="green">м.р.</font></i><p style="padding-left:1em;margin:0">denticle</p>
зуд	<object type="audio/x-wav" data="05177.wav" width="40" height="40"><param name="autoplay" value="false" /></object><br/><i class="p"><font color="green">м.р.</font></i><p style="padding-left:1em;margin:0">itch</p>
зудеть	<b>зуд<u class="accent">е</u>ть</b><br/><b>I</b> <object type="audio/x-wav" data="05178.wav" width="40" height="40"><param name="autoplay" value="false" /></object><br/><i class="p"><font color="green">несовер.</font></i><font color="green">;</font> <i class="p"><font color="green">без доп.</font></i><p style="padding-left:1em;margin:0">itch</p><br/><b>II</b> <i class="p"><font color="green">несовер.</font></i><font color="green">;</font> <i class="p"><font color="green">без доп.</font></i><p style="padding-left:1em;margin:0">zoom; nag <i class="p"><font color="green">перен.</font></i> <i>(надоедать)</i></p>
зудить	<b>зуд<u class="accent">и</u>ть</b><br/><i class="p"><font color="green">несовер.</font></i><font color="green">;</font> <i class="p"><font color="green">без доп.</font></i><font color="green">;</font> <i class="p"><font color="green">разг.</font></i><p style="padding-left:1em;margin:0">zoom; nag <i class="p"><font color="green">перен.</font></i> <i>(надоедать)</i></p>
зудящий	<i class="p"><font color="green">прил.</font></i><p style="padding-left:1em;margin:0">itching</p>
зуек	<font color="green">(зуёк)</font> <i class="p"><font color="green">м.р.</font></i><font color="green">;</font> <i class="p"><font color="green">зоол.</font></i><p style="padding-left:1em;margin:0">plover</p><p style="padding-left:2em;margin:0"><span class="sec"><b>Syn:</b></span></p><p style="padding-left:2em;margin:0"><span class="sec"><a href="bword://ржанка">ржанка</a></span></p>
зулус	<b>зул<u class="accent">у</u>с</b><br/><i class="p"><font color="green">м.р.</font></i><p style="padding-left:1em;margin:0">Zulu</p>
зулуска	<b>зул<u class="accent">у</u>ска</b><br/><i class="p"><font color="green">ж.р.</font></i><p style="padding-left:1em;margin:0">Zulu</p>
зулусский	<b>зул<u class="accent">у</u>сский</b><br/><i class="p"><font color="green">прил.</font></i><p style="padding-left:1em;margin:0">Zulu</p>
зулусский язык	<p style="padding-left:1em;margin:0">Zulu</p>
зуммер	<b>з<u class="accent">у</u>ммер</b><br/><i class="p"><font color="green">м.р.</font></i><font color="green">;</font> <i class="p"><font color="green">тех.</font></i><p style="padding-left:1em;margin:0">buzzer</p>
зумпф	<i class="p"><font color="green">м.р.</font></i><font color="green">;</font> <i class="p"><font color="green">горн.</font></i><p style="padding-left:1em;margin:0">dibhole, sump, well</p>
Зунд	<i class="p"><font color="green">м.р.</font></i><font color="green">;</font> <i class="p"><font color="green">геогр.</font></i><p style="padding-left:1em;margin:0"><i>(пролив)</i> Sound</p>
зыбиться	<b>з<u class="accent">ы</u>биться</b><br/><i class="p"><font color="green">несовер.</font></i><p style="padding-left:1em;margin:0">be ruffled <i>(о море <i class="p"><font color="green">||</font></i> of the sea)</i>; toss</p>
зыбка	<b>з<u class="accent">ы</u>бка</b><br/><i class="p"><font color="green">ж.р.</font></i><font color="green">;</font> <i class="p"><font color="green">разг.</font></i><p style="padding-left:1em;margin:0">cradle</p>
зыбкая поверхность	<p style="padding-left:1em;margin:0">rippled surface</p>
зыбкий	<b>з<u class="accent">ы</u>бкий</b><br/><i class="p"><font color="green">прил.</font></i><p style="padding-left:1em;margin:0">loose; shaky; unsteady, unstable; swelling, rippled; vague <i>(смутный)</i></p><p style="padding-left:2em;margin:0"><span class="sec">- <a href="bword://зыбкая поверхность">зыбкая поверхность</a></span></p><p style="padding-left:2em;margin:0"><span class="sec">- <a href="bword://зыбкое болото">зыбкое болото</a></span></p><p style="padding-left:2em;margin:0"><span class="sec">- <a href="bword://зыбкое положение">зыбкое положение</a></span></p>
зыбкое болото	<p style="padding-left:1em;margin:0">quaking bog</p>
зыбкое положение	<i class="p"><font color="green">перен.</font></i><p style="padding-left:1em;margin:0">tricky situation</p>
зыбучие пески	<p style="padding-left:1em;margin:0">quicksands; running sand <i class="p"><font color="green">ед.</font></i></p>
зыбучий	<b>зыб<u class="accent">у</u>чий</b><br/><i class="p"><font color="green">прил.</font></i><p style="padding-left:1em;margin:0">unsteady, unstable</p><p style="padding-left:2em;margin:0"><span class="sec"><span class="ex"><font color="steelblue">зыбучие пески — quicksands</font></span></span></p>
зыбь	<i class="p"><font color="green">ж.р.</font></i><p style="padding-left:1em;margin:0">ripple; swell, surge</p><p style="padding-left:2em;margin:0"><span class="sec"><span class="ex"><font color="steelblue">зыбь на море — choppy sea</font></span></span></p><p style="padding-left:2em;margin:0"><span class="sec">- <a href="bword://подернуться зыбью">подернуться зыбью</a></span></p>
зыкать	<b>з<u class="accent">ы</u>кать</b><br/><i class="p"><font color="green">несовер.</font></i> <font color="green">– зыкать;</font> <i class="p"><font color="green">совер.</font></i> <font color="green">– зыкнуть (на кого-л.);</font> <i class="p"><font color="green">разг.</font></i><p style="padding-left:1em;margin:0">cut short; speak brusquely / curtly (to), bark (at)</p>
зыкнуть	<i class="p"><font color="green">совер.</font></i> <i class="p"><font color="green">от</font></i> <a href="bword://зыкать">зыкать</a>
зычный	<b>з<u class="accent">ы</u>чный</b><br/><i class="p"><font color="green">прил.</font></i><p style="padding-left:1em;margin:0">ringing, loud, stentorian</p>
зэк	<p style="padding-left:1em;margin:0"><i class="p"><font color="green">м.р.</font></i><font color="green">;</font> <i class="p"><font color="green">угол. сл.</font></i></p><p style="padding-left:1em;margin:0">prisoner</p>
зюйд	<b>з<u class="accent">ю</u>йд</b><br/><i class="p"><font color="green">м.р.</font></i><font color="green">;</font> <i class="p"><font color="green">мор.</font></i><p style="padding-left:1em;margin:0"><font color="brown">1)</font> south</p><p style="padding-left:1em;margin:0"><font color="brown">2)</font> southerly wind</p>
зюйд-вест	<b>зюйд-в<u class="accent">е</u>ст</b><br/><i class="p"><font color="green">м.р.</font></i><font color="green">;</font> <i class="p"><font color="green">мор.</font></i><p style="padding-left:1em;margin:0"><font color="brown">1)</font> south-west</p><p style="padding-left:1em;margin:0"><font color="brown">2)</font> southwester</p>
зюйд-ост	<b>зюйд-<u class="accent">о</u>ст</b><br/><i class="p"><font color="green">м.р.</font></i><font color="green">;</font> <i class="p"><font color="green">мор.</font></i><p style="padding-left:1em;margin:0"><font color="brown">1)</font> south-east</p><p style="padding-left:1em;margin:0"><font color="brown">2)</font> southeaster</p>
зюйдвестка	<b>зюйдв<u class="accent">е</u>стка</b><br/><i class="p"><font color="green">ж.р.</font></i><font color="green">;</font> <i class="p"><font color="green">мор.</font></i><p style="padding-left:1em;margin:0">sou'wester</p>
зябкий	<b>з<u class="accent">я</u>бкий</b><br/><i class="p"><font color="green">прил.</font></i><p style="padding-left:1em;margin:0">chilly, sensitive to cold</p>
зябко	<b>з<u class="accent">я</u>бко</b><br/><i class="p"><font color="green">нареч.</font></i><p style="padding-left:1em;margin:0">chilly</p>
зяблик	<b>з<u class="accent">я</u>блик</b><br/><i class="p"><font color="green">м.р.</font></i><p style="padding-left:1em;margin:0">chaffinch</p>
зяблина|морозобоина	<b>морозоб<u class="accent">о</u>ина</b><br/><i class="p"><font color="green">ж.р.</font></i><p style="padding-left:1em;margin:0">frost-cleft</p>
зябнуть	<b>з<u class="accent">я</u>бнуть</b><br/><i class="p"><font color="green">несовер.</font></i> <font color="green">– зябнуть;</font> <i class="p"><font color="green">совер.</font></i> <font color="green">– прозябнуть, озябнуть</font> <i class="p"><font color="green">без доп.</font></i><p style="padding-left:1em;margin:0">feel chilly; freeze, shiver</p>
зябь	<i class="p"><font color="green">ж.р.</font></i><font color="green">;</font> <i class="p"><font color="green">с.-х.</font></i><p style="padding-left:1em;margin:0">winter tillage</p>
зять	<object type="audio/x-wav" data="05179.wav" width="40" height="40"><param name="autoplay" value="false" /></object><br/><i class="p"><font color="green">м.р.</font></i><p style="padding-left:1em;margin:0">son-in-law <i>(муж дочери <i class="p"><font color="green">||</font></i> daughter's husband)</i>; brother-in-law <i>(муж сестры <i class="p"><font color="green">||</font></i> sister's husband)</i></p>
и	<p style="padding-left:1em;margin:0"><b>1.</b> <object type="audio/x-wav" data="05180.wav" width="40" height="40"><param name="autoplay" value="false" /></object><br/><i class="p"><font color="green">союз</font></i></p><p style="padding-left:1em;margin:0"><font color="brown">1)</font> <i>(соединение)</i> and; <i>(последовательность)</i> and then; <i>(соответствие ожидавшемуся)</i> and so</p><p style="padding-left:2em;margin:0"><span class="sec"><span class="ex"><font color="steelblue">стол и стул — a table and a chair</font></span></span></p><p style="padding-left:2em;margin:0"><span class="sec"><span class="ex"><font color="steelblue">они стояли и ждали — they stood and waited</font></span></span></p><p style="padding-left:2em;margin:0"><span class="sec"><span class="ex"><font color="steelblue">и он уехал — and then he left</font></span></span></p><p style="padding-left:2em;margin:0"><span class="sec"><span class="ex"><font color="steelblue">он собирался уехать и уехал — he thought he would leave and so he did</font></span></span></p><p style="padding-left:1em;margin:0"><font color="brown">2)</font> <i>(именно)</i> that is what, that is where, that is who</p><p style="padding-left:2em;margin:0"><span class="sec"><span class="ex"><font color="steelblue">здесь он и жил — it was here that he lived</font></span></span></p><p style="padding-left:2em;margin:0"><span class="sec"><span class="ex"><font color="steelblue">вот об этом-то он и думает — that is what he is thinking of</font></span></span></p><p style="padding-left:2em;margin:0"><span class="sec"><span class="ex"><font color="steelblue">этого человека они и ждали — that is the man they have been waiting for</font></span></span></p><p style="padding-left:1em;margin:0"><font color="brown">3)</font> <i>(с сослагательным наклонением; не переводится <i class="p"><font color="green">||</font></i> with subjunctive mood; not translated)</i>:</p><p style="padding-left:2em;margin:0"><span class="sec"><span class="ex"><font color="steelblue">он и пошел бы, да не может — he would like to go but he cannot</font></span></span></p><p style="padding-left:1em;margin:0"><font color="brown">4)</font> <i>(также)</i> too; <i>(при отрицании <i class="p"><font color="green">||</font></i> with negative)</i> either</p><p style="padding-left:2em;margin:0"><span class="sec">- <a href="bword://и в этом случае">и в этом случае</a></span></p><p style="padding-left:2em;margin:0"><span class="sec">- <a href="bword://и не там">и не там</a></span></p><p style="padding-left:2em;margin:0"><span class="sec"><span class="ex"><font color="steelblue">и он не сделал этого — he did not do either</font></span></span></p><p style="padding-left:2em;margin:0"><span class="sec"><span class="ex"><font color="steelblue">это и для него нелегко — it is not easy for him either</font></span></span></p><p style="padding-left:1em;margin:0"><font color="brown">5)</font> <i>(при перечислении <i class="p"><font color="green">||</font></i> when enumerating)</i> and</p><p style="padding-left:2em;margin:0"><span class="sec"><span class="ex"><font color="steelblue">и... и... — both... and...</font></span></span></p><p style="padding-left:2em;margin:0"><span class="sec"><span class="ex"><font color="steelblue">и мужчины, и женщины, и дети — men, women and children</font></span></span></p><p style="padding-left:2em;margin:0"><span class="sec"><span class="ex"><font color="steelblue">и армия и флот — both the army and the navy</font></span></span></p><p style="padding-left:1em;margin:0"><font color="brown">6)</font> <i>(даже)</i> even</p><p style="padding-left:2em;margin:0"><span class="sec"><span class="ex"><font color="steelblue">он и спасибо не сказал — he did not even say thank you</font></span></span></p><p style="padding-left:1em;margin:0"><span class="sec">•</span></p><p style="padding-left:1em;margin:0">- <a href="bword://и так далее">и так далее</a></p><p style="padding-left:1em;margin:0">- <a href="bword://и вот">и вот</a></p><p style="padding-left:1em;margin:0">- <a href="bword://и другие">и другие</a></p><p style="padding-left:1em;margin:0"><b>2.</b> <i class="p"><font color="green">межд.</font></i><font color="green">;</font> <i class="p"><font color="green">уст.</font></i></p><p style="padding-left:1em;margin:0">now!, well!</p><p style="padding-left:2em;margin:0"><span class="sec"><span class="ex"><font color="steelblue">И, полно! — Well, that's enough!</font></span></span></p>
и в этом случае	<p style="padding-left:1em;margin:0">in this case too</p>
и виду не показывать	<p style="padding-left:1em;margin:0">to seem to know nothing; to look unconcerned; to show / give no sign</p>
и вот	<p style="padding-left:1em;margin:0">and now</p>
и все такое	<i class="p"><font color="green">разг.</font></i><p style="padding-left:1em;margin:0">and so on</p>
и дело с концом	<p style="padding-left:1em;margin:0"><i class="p"><font color="green">разг.</font></i><br/> and there is an end to it</p>
